啊	口, 阿	口, 阝, 一, 亅, 口	口, 丨, ㇌, 一, 亅, 口
阿	阝, 可	阝, 一, 亅, 口	丨, ㇌, 一, 亅, 口
埃	土, 矣	土, 厶, 矢	一, 丨, 一, ㇛, 丶, 丿, 一, 人, 一
挨	扌, 矣	扌, 厶, 矢	亅, 二, ㇛, 丶, 丿, 一, 人, 一
哎	口, 艾	口, 艹, 乂	口, 艹, 乂
唉	口, 矣	口, 厶, 矢	口, ㇛, 丶, 丿, 一, 人, 一
哀	衣, 口	衣, 口	一, 丶, ㇒, ㇗, 冫, 口
皑	白, 岂	白, 山, 己	口, 一, ㇒, 丨, 凵, 匚, 乚
癌	疒, 嵒	疒, 品, 山	一, 丶, 厂, 丶, 品, 丨, 凵
蔼	艹, 谒	艹, 讠, 曰, 勹, 人, ㇗	艹, ㇊, 丶, 口, 一, ㇆, ㇒, 人, ㇗
矮	矢, 委	矢, 禾, 女	丿, 一, 人, 一, ㇒, 一, 丨, 八, ㇛, 一, 丿
艾	艹, 乂	艹, 乂	艹, 乂
碍	石, 㝵	石, 日, 一, 寸	一, 丿, 口, 口, 一, 一, 𠂇, 亅, 丶
爱	No glyph available, 友	爫, 冖, 𠂇, 又	爫, 冖, 𠂇, ㇇, ㇏
隘	阝, 益	阝, 丷, 一, 八, 皿	丨, ㇌, 丷, 一, 八, 冂, 丨, 一
鞍	革, 安	革, 宀, 女	卄, 一, 口, 丨, 一, 丨, 冖, 丶, ㇛, 一, 丿
氨	气, 安	气, 宀, 女	丿, 一, 一, ㇠, 冖, 丶, ㇛, 一, 丿
安	宀, 女	宀, 女	冖, 丶, ㇛, 一, 丿
俺	亻, 奄	亻, 大, 日, 丨, 乚	㇒, 丨, 人, 一, 口, 一, 丨, 乚
按	扌, 安	扌, 宀, 女	亅, 二, 冖, 丶, ㇛, 一, 丿
暗	日, 音	日, 音	口, 一, 一, 丶, 丷, 一, 口, 一
岸	山, 厈	山, 厂, 干	丨, 凵, 厂, 一, 一, 丨
胺	月, 安	月, 宀, 女	冂, 二, 冖, 丶, ㇛, 一, 丿
案	安, 木	宀, 女, 木	冖, 丶, ㇛, 一, 丿, 一, 丨, 八
肮	月, 亢	月, 亠, 几	冂, 二, 一, 丶, 丿, ㇠
昂	日, 卬	日, ㇒, ㇗, 卩	口, 一, ㇒, ㇗, 丨, ㇆
盎	央, 皿	大, 冂, 皿	人, 一, 冂, 冂, 丨, 一
凹	凵	凹	凹
敖	No glyph available, ⺙	龶, 一, 丿, ㇆, ⺙	龶, 一, 丿, ㇆, 丿, 一, 乂
熬	敖, 灬	龶, 一, 丿, ㇆, ⺙, 灬	龶, 一, 丿, ㇆, 丿, 一, 乂, 灬
翱	皋, 羽	白, 大, 十, 羽	口, 一, ㇒, 人, 一, 一, 丨, 羽
袄	衤, 夭	衤, ㇒, 大	一, 一, 丨, 一, 丶, 戈, 丨, 冫, ㇒, 人, 一
傲	亻, 敖	亻, 龶, 一, 丿, ㇆, ⺙	㇒, 丨, 龶, 一, 丿, ㇆, 丿, 一, 乂
奥	No glyph available, 大	宀, 米, 大	冖, 丶, 一, 丨, 八, 丷, 人, 一
懊	忄, 奥	忄, 宀, 米, 大	丨, 八, 冖, 丶, 一, 丨, 八, 丷, 人, 一
澳	氵, 奥	氵, 宀, 米, 大	⺀, ㇀, 冖, 丶, 一, 丨, 八, 丷, 人, 一
芭	艹, 巴	艹, 丨, No glyph availabl, 丨, 乚	艹, 丨, 匚, 丨, 乚
捌	扌, 别	扌, 口, 力, 刂	亅, 二, 口, ㇆, 丿, 亅, 丨
扒	扌, 八	扌, 八	亅, 二, 八
叭	口, 八	口, 八	口, 八
吧	口, 巴	口, 丨, No glyph availabl, 丨, 乚	口, 丨, 匚, 丨, 乚
笆	⺮, 巴	⺮, 丨, No glyph availabl, 丨, 乚	⺮, 丨, 匚, 丨, 乚
八	㇒	八	八
疤	疒, 巴	疒, 丨, No glyph availabl, 丨, 乚	一, 丶, 厂, 丶, 丨, 匚, 丨, 乚
巴	𠃜, 乚	丨, No glyph availabl, 丨, 乚	丨, 匚, 丨, 乚
拔	扌, 犮	扌, 𠂇, 丶, 又	亅, 二, 𠂇, 丶, ㇇, ㇏
跋	⻊, 犮	⻊, 𠂇, 丶, 又	口, 丨, 一, 丨, 一, 𠂇, 丶, ㇇, ㇏
靶	革, 巴	革, 丨, No glyph availabl, 丨, 乚	卄, 一, 口, 丨, 一, 丨, 丨, 匚, 丨, 乚
把	扌, 巴	扌, 丨, No glyph availabl, 丨, 乚	亅, 二, 丨, 匚, 丨, 乚
耙	耒, 巴	耒, 丨, No glyph availabl, 丨, 乚	一, 二, 丨, 八, 丨, 匚, 丨, 乚
坝	土, 贝	土, 贝	一, 丨, 一, 冂, 人
霸	雨, 䩗	雨, 革, 月	一, 冂, 丨, 丶, ㇀, 冫, 卄, 一, 口, 丨, 一, 丨, 冂, 二
罢	罒, 去	罒, 土, 厶	口, 丨, 一, 丨, 一, ㇛, 丶
爸	父, 巴	父, 丨, No glyph availabl, 丨, 乚	八, 乂, 丨, 匚, 丨, 乚
白	日, ㇒	白	口, 一, ㇒
柏	木, 白	木, 白	一, 丨, 八, 口, 一, ㇒
百	一, 白	一, 白	一, 口, 一, ㇒
摆	扌, 罢	扌, 罒, 土, 厶	亅, 二, 口, 丨, 一, 丨, 一, ㇛, 丶
佰	亻, 百	亻, 一, 白	㇒, 丨, 一, 口, 一, ㇒
败	贝, ⺙	贝, ⺙	冂, 人, 丿, 一, 乂
拜	龵, No glyph available	龵, 一, 一, 二, 丨	龵, 一, 一, 二, 丨
稗	禾, 卑	禾, 冂, 二, 丨, 丶, 十	㇒, 一, 丨, 八, 冂, 二, 丨, 丶, 一, 丨
斑	玨, 文	玨, 文	玨, 一, 丶, 乂
班	玨, No glyph available	玨, 丿, 丶	玨, 丿, 丶
搬	扌, 般	扌, 舟, 殳	亅, 二, 冂, 丶, ⺀, 一, 丿, ㇠, ㇇, ㇏
扳	扌, 反	扌, ⺁, 又	亅, 二, 丿, ㇒, ㇇, ㇏
般	舟, 殳	舟, 殳	冂, 丶, ⺀, 一, 丿, ㇠, ㇇, ㇏
颁	分, 页	八, 刀, 页	八, ㇆, 丿, 一, 丿, 冂, 人
板	木, 反	木, ⺁, 又	一, 丨, 八, 丿, ㇒, ㇇, ㇏
版	片, 反	片, ⺁, 又	丨, 丨, 一, ㇕, 丿, ㇒, ㇇, ㇏
扮	扌, 分	扌, 八, 刀	亅, 二, 八, ㇆, 丿
拌	扌, 半	扌, 二, 丨, 丷	亅, 二, 二, 丨, 丷
伴	亻, 半	亻, 二, 丨, 丷	㇒, 丨, 二, 丨, 丷
瓣	辡, 瓜	辡, 瓜	辡, 丿, ㇒, ㇏, ㇛, 丶
半	No glyph available, 丷	二, 丨, 丷	二, 丨, 丷
办	力, 八	力, 八	㇆, 丿, 八
绊	纟, 半	纟, 二, 丨, 丷	㇛, 一, 二, 丨, 丷
邦	丰, 阝	一, 二, 丨, 阝	一, 二, 丨, 丨, ㇌
帮	邦, 巾	一, 二, 丨, 阝, 巾	一, 二, 丨, 丨, ㇌, 冂, 丨
梆	木, 邦	木, 一, 二, 丨, 阝	一, 丨, 八, 一, 二, 丨, 丨, ㇌
榜	木, 旁	木, 亠, 丷, 冖, 方	一, 丨, 八, 一, 丶, 丷, 冖, 一, 丶, 丿, ㇆
膀	月, 旁	月, 亠, 丷, 冖, 方	冂, 二, 一, 丶, 丷, 冖, 一, 丶, 丿, ㇆
绑	纟, 邦	纟, 一, 二, 丨, 阝	㇛, 一, 一, 二, 丨, 丨, ㇌
棒	木, 奉	木, 一, 二, 丨, 八, 二, 丨	一, 丨, 八, 一, 二, 丨, 八, 二, 丨
磅	石, 旁	石, 亠, 丷, 冖, 方	一, 丿, 口, 一, 丶, 丷, 冖, 一, 丶, 丿, ㇆
蚌	虫, 丰	虫, 一, 二, 丨	口, 丨, 𠂉, 一, 二, 丨
镑	钅, 旁	钅, 亠, 丷, 冖, 方	丿, 一, 乚, 二, 一, 丶, 丷, 冖, 一, 丶, 丿, ㇆
傍	亻, 旁	亻, 亠, 丷, 冖, 方	㇒, 丨, 一, 丶, 丷, 冖, 一, 丶, 丿, ㇆
谤	讠, 旁	讠, 亠, 丷, 冖, 方	㇊, 丶, 一, 丶, 丷, 冖, 一, 丶, 丿, ㇆
苞	艹, 包	艹, 勹, 巳	艹, ㇆, ㇒, 丨, 匚, 乚
胞	月, 包	月, 勹, 巳	冂, 二, ㇆, ㇒, 丨, 匚, 乚
包	勹, 巳	勹, 巳	㇆, ㇒, 丨, 匚, 乚
褒	衣, 保	衣, 亻, 口, 木	一, 丶, ㇒, ㇗, 冫, ㇒, 丨, 口, 一, 丨, 八
剥	录, 刂	彐, 氺, 刂	㇕, 二, 亅, 丶, ㇀, 冫, 亅, 丨
薄	艹, 溥	艹, 氵, 十, 用, 丶, 寸	艹, ⺀, ㇀, 一, 丨, 冂, 二, 丨, 丶, 𠂇, 亅, 丶
雹	雨, 包	雨, 勹, 巳	一, 冂, 丨, 丶, ㇀, 冫, ㇆, ㇒, 丨, 匚, 乚
保	亻, 呆	亻, 口, 木	㇒, 丨, 口, 一, 丨, 八
堡	保, 土	亻, 口, 木, 土	㇒, 丨, 口, 一, 丨, 八, 一, 丨, 一
饱	饣, 包	饣, 勹, 巳	⺈, 乚, ㇆, ㇒, 丨, 匚, 乚
宝	宀, 玉	宀, 玉	冖, 丶, 一, 一, 丨, 一, 丶
抱	扌, 包	扌, 勹, 巳	亅, 二, ㇆, ㇒, 丨, 匚, 乚
报	扌, 𠬝	扌, 卩, 又	亅, 二, 丨, ㇆, ㇇, ㇏
暴	日, No glyph available	日, 艹, 一, 八, 水	口, 一, 艹, 一, 八, 亅, ㇇, 冫
豹	豸, 勺	豸, 勹, 丶	爫, ㇁, ㇒, ㇆, ㇒, 丶
鲍	鱼, 包	鱼, 勹, 巳	⺈, 冂, 一, 丨, 一, 一, ㇆, ㇒, 丨, 匚, 乚
爆	火, 暴	火, 日, 艹, 一, 八, 水	丿, 丶, 冫, 口, 一, 艹, 一, 八, 亅, ㇇, 冫
杯	木, 不	木, 一, 丿, 卜	一, 丨, 八, 一, 丿, 丨, 丶
碑	石, 卑	石, 冂, 二, 丨, 丶, 十	一, 丿, 口, 冂, 二, 丨, 丶, 一, 丨
悲	非, 心	非, 心	非, 𠁼, ㇃
卑	No glyph available, 十	冂, 二, 丨, 丶, 十	冂, 二, 丨, 丶, 一, 丨
北	匕	北	北
辈	非, 车	非, 车	非, 乚, 一, 一, 丨
背	北, 月	北, 月	北, 冂, 二
贝	冂, 人	贝	冂, 人
钡	钅, 贝	钅, 贝	丿, 一, 乚, 二, 冂, 人
倍	亻, 咅	亻, 立, 口	㇒, 丨, 一, 丶, 丷, 一, 口
狈	犭, 贝	犭, 贝	㇁, ㇒, 冂, 人
备	夂, 田	夂, 田	㇇, ㇏, ㇒, 冂, 一, 丨, 一
惫	夂, 思	夂, 田, 心	㇇, ㇏, ㇒, 冂, 一, 丨, 一, 𠁼, ㇃
焙	火, 咅	火, 立, 口	丿, 丶, 冫, 一, 丶, 丷, 一, 口
被	衤, 皮	衤, 皮	一, 一, 丨, 一, 丶, 戈, 丨, 冫, 丿, ㇆, 丨, ㇇, ㇏
奔	大, 卉	大, 十, 艹	人, 一, 一, 丨, 艹
苯	艹, 本	艹, 木, 一	艹, 一, 丨, 八, 一
本	木, 一	木, 一	一, 丨, 八, 一
笨	⺮, 本	⺮, 木, 一	⺮, 一, 丨, 八, 一
崩	山, 朋	山, 朋	丨, 凵, 朋
绷	纟, 朋	纟, 朋	㇛, 一, 朋
甭	不, 用	一, 丿, 卜, 用	一, 丿, 丨, 丶, 冂, 二, 丨
泵	石, 水	石, 水	一, 丿, 口, 亅, ㇇, 冫
蹦	⻊, 崩	⻊, 山, 朋	口, 丨, 一, 丨, 一, 丨, 凵, 朋
迸	辶, 并	辶, 丷, 一, 廾	丶, ㇆, ㇝, 丷, 一, 廾
逼	辶, 畐	辶, 一, 口, 田	丶, ㇆, ㇝, 一, 口, 冂, 一, 丨, 一
鼻	自, 畀	鼻	口, 二, 丶, 冂, 一, 丨, 一, 一, 丨
比	匕	比	比
鄙	啚, 阝	口, 十, 回, 阝	口, 一, 丨, 回, 丨, ㇌
笔	⺮, 毛	⺮, 毛	⺮, ㇒, 二, 乚
彼	彳, 皮	彳, 皮	㇒, 丨, 丿, ㇆, 丨, ㇇, ㇏
碧	珀, 石	王, 白, 石	一, 一, 丨, 一, 口, 一, ㇒, 一, 丿, 口
蓖	艹, No glyph available	艹, 囗, 丶, 乂, No glyph availabl	艹, 冂, 一, 丶, 乂, 匕
蔽	艹, 敝	艹, 巾, 冫, No glyph availabl, ⺙	艹, 冂, 丨, 丶, ㇀, 冫, 丿, 一, 乂
毕	比, 十	比, 十	比, 一, 丨
毙	比, 死	比, 歹, 匕	比, 一, 夕, 乚, ㇒
毖	比, 必	比, 心, 丿	比, 𠁼, ㇃, 丿
币	㇒, 巾	㇒, 巾	㇒, 冂, 丨
庇	广, 比	广, 比	厂, 丶, 比
痹	疒, 畀	疒, 田, 一, No glyph availabl	一, 丶, 厂, 丶, 冂, 一, 丨, 一, 一, 丨
闭	门, 才	门, 𠂇, ㇒	丶, 丨, ㇆, 𠂇, ㇒
敝	㡀, ⺙	巾, 冫, No glyph availabl, ⺙	冂, 丨, 丶, ㇀, 冫, 丿, 一, 乂
弊	敝, 艹	巾, 冫, No glyph availabl, ⺙, 艹	冂, 丨, 丶, ㇀, 冫, 丿, 一, 乂, 艹
必	心, 丿	心, 丿	𠁼, ㇃, 丿
辟	𡰪, 辛	尸, 口, 辛	丨, 匚, 口, 一, 丶, 丷, 一, 一, 丨
壁	辟, 土	尸, 口, 辛, 土	丨, 匚, 口, 一, 丶, 丷, 一, 一, 丨, 一, 丨, 一
臂	辟, 月	尸, 口, 辛, 月	丨, 匚, 口, 一, 丶, 丷, 一, 一, 丨, 冂, 二
避	辶, 辟	辶, 尸, 口, 辛	丶, ㇆, ㇝, 丨, 匚, 口, 一, 丶, 丷, 一, 一, 丨
陛	阝, 坒	阝, 比, 土	丨, ㇌, 比, 一, 丨, 一
鞭	革, 便	革, 亻, 一, 日, 丨, 乂	卄, 一, 口, 丨, 一, 丨, ㇒, 丨, 一, 口, 一, 丨, 乂
边	辶, 力	辶, 力	丶, ㇆, ㇝, ㇆, 丿
编	纟, 扁	纟, 户, 冂, 艹	㇛, 一, 丨, 匚, 丶, 冂, 艹
贬	贝, 乏	贝, ㇒, 王, 丶, 戈, ㇝	冂, 人, ㇒, 一, 一, 丨, 一, 丶, 戈, ㇝
扁	户, 𠕁	户, 冂, 艹	丨, 匚, 丶, 冂, 艹
便	亻, 更	亻, 一, 日, 丨, 乂	㇒, 丨, 一, 口, 一, 丨, 乂
变	亦, 又	亠, 丨, 亅, 八, 又	一, 丶, 丨, 亅, 八, ㇇, ㇏
卞	亠, 卜	亠, 卜	一, 丶, 丨, 丶
辨	辡, No glyph available	辡, 丿, 丶	辡, 丿, 丶
辩	辡, 讠	辡, 讠	辡, ㇊, 丶
辫	辡, 纟	辡, 纟	辡, ㇛, 一
遍	辶, 扁	辶, 户, 冂, 艹	丶, ㇆, ㇝, 丨, 匚, 丶, 冂, 艹
标	木, 示	木, 示	一, 丨, 八, 二, 亅, 八
彪	虎, 彡	虍, 几, 彡	丨, 一, 冖, 乚, 一, 丿, ㇠, 彡
膘	月, 票	月, 覀, 示	冂, 二, 覀, 二, 亅, 八
表	龶, 𧘇	龶, ㇒, ㇗, No glyph availabl	龶, ㇒, ㇗, 冫
鳖	敝, 鱼	巾, 冫, No glyph availabl, ⺙, 鱼	冂, 丨, 丶, ㇀, 冫, 丿, 一, 乂, ⺈, 冂, 一, 丨, 一, 一
憋	敝, 心	巾, 冫, No glyph availabl, ⺙, 心	冂, 丨, 丶, ㇀, 冫, 丿, 一, 乂, 𠁼, ㇃
别	另, 刂	口, 力, 刂	口, ㇆, 丿, 亅, 丨
瘪	No glyph available, 仑	疒, 自, 人, 匕	一, 丶, 厂, 丶, 口, 二, 丶, 人, 乚, ㇒
彬	林, 彡	林, 彡	林, 彡
斌	文, 武	文, 一, 弋, 止	一, 丶, 乂, 一, 弋, 丨, 一, 丨, 一
濒	氵, 频	氵, 止, 小, 丿, 页	⺀, ㇀, 丨, 一, 丨, 一, 亅, 八, 丿, 一, 丿, 冂, 人
滨	氵, 宾	氵, 宀, 兵	⺀, ㇀, 冖, 丶, 兵
宾	宀, 兵	宀, 兵	冖, 丶, 兵
摈	扌, 宾	扌, 宀, 兵	亅, 二, 冖, 丶, 兵
兵	𠔊	兵	兵
冰	冫, 水	冫, 水	丶, ㇀, 亅, ㇇, 冫
柄	木, 丙	木, 一, 人, 冂	一, 丨, 八, 一, 人, 冂
丙	一, 内	一, 人, 冂	一, 人, 冂
秉	禾, ⺕	禾, ⺕	㇒, 一, 丨, 八, 匚, 一
饼	饣, 并	饣, 丷, 一, 廾	⺈, 乚, 丷, 一, 廾
炳	火, 丙	火, 一, 人, 冂	丿, 丶, 冫, 一, 人, 冂
病	疒, 丙	疒, 一, 人, 冂	一, 丶, 厂, 丶, 一, 人, 冂
并	丷, 开	丷, 一, 廾	丷, 一, 廾
玻	王, 皮	王, 皮	一, 一, 丨, 一, 丿, ㇆, 丨, ㇇, ㇏
菠	艹, 波	艹, 氵, 皮	艹, ⺀, ㇀, 丿, ㇆, 丨, ㇇, ㇏
播	扌, 番	扌, 釆, 田	亅, 二, ㇒, 一, 丨, 八, 丷, 冂, 一, 丨, 一
拨	扌, 发	扌, ㇗, 丨, 丶, 又	亅, 二, ㇗, 丨, 丶, ㇇, ㇏
钵	钅, 本	钅, 木, 一	丿, 一, 乚, 二, 一, 丨, 八, 一
波	氵, 皮	氵, 皮	⺀, ㇀, 丿, ㇆, 丨, ㇇, ㇏
博	十, 尃	十, 十, 用, 丶, 寸	一, 丨, 一, 丨, 冂, 二, 丨, 丶, 𠂇, 亅, 丶
勃	孛, 力	十, 冖, 子, 力	一, 丨, 冖, ㇇, 亅, 一, ㇆, 丿
搏	扌, 尃	扌, 十, 用, 丶, 寸	亅, 二, 一, 丨, 冂, 二, 丨, 丶, 𠂇, 亅, 丶
铂	钅, 白	钅, 白	丿, 一, 乚, 二, 口, 一, ㇒
箔	⺮, 泊	⺮, 氵, 白	⺮, ⺀, ㇀, 口, 一, ㇒
伯	亻, 白	亻, 白	㇒, 丨, 口, 一, ㇒
帛	白, 巾	白, 巾	口, 一, ㇒, 冂, 丨
舶	舟, 白	舟, 白	冂, 丶, ⺀, 一, 口, 一, ㇒
脖	月, 孛	月, 十, 冖, 子	冂, 二, 一, 丨, 冖, ㇇, 亅, 一
膊	月, 尃	月, 十, 用, 丶, 寸	冂, 二, 一, 丨, 冂, 二, 丨, 丶, 𠂇, 亅, 丶
渤	氵, 勃	氵, 十, 冖, 子, 力	⺀, ㇀, 一, 丨, 冖, ㇇, 亅, 一, ㇆, 丿
泊	氵, 白	氵, 白	⺀, ㇀, 口, 一, ㇒
驳	马, 爻	马, 爻	㇕, ㇉, 一, 爻
捕	扌, 甫	扌, 十, 用, 丶	亅, 二, 一, 丨, 冂, 二, 丨, 丶
卜	丨, 丶	卜	丨, 丶
哺	口, 甫	口, 十, 用, 丶	口, 一, 丨, 冂, 二, 丨, 丶
补	衤, 卜	衤, 卜	一, 一, 丨, 一, 丶, 戈, 丨, 冫, 丨, 丶
埠	土, 阜	土, 阜	一, 丨, 一, 㠯, 丶, 一, 丨
不	丆, 卜	一, 丿, 卜	一, 丿, 丨, 丶
布	𠂇, 巾	𠂇, 巾	𠂇, 冂, 丨
步	止, 𣥂	止, 小, 丿	丨, 一, 丨, 一, 亅, 八, 丿
簿	⺮, 溥	⺮, 氵, 十, 用, 丶, 寸	⺮, ⺀, ㇀, 一, 丨, 冂, 二, 丨, 丶, 𠂇, 亅, 丶
部	咅, 阝	立, 口, 阝	一, 丶, 丷, 一, 口, 丨, ㇌
怖	忄, 布	忄, 𠂇, 巾	丨, 八, 𠂇, 冂, 丨
擦	扌, 察	扌, 宀, 月, 卩, 示	亅, 二, 冖, 丶, 冂, 二, 丨, ㇆, 二, 亅, 八
猜	犭, 青	犭, 青	㇁, ㇒, 龶, 冂, 二
裁	𢦏, 衣	土, 戈, 衣	一, 丨, 一, 戈, 一, 丶, ㇒, ㇗, 冫
材	木, 才	木, 𠂇, ㇒	一, 丨, 八, 𠂇, ㇒
才	𠂇, ㇒	𠂇, ㇒	𠂇, ㇒
财	贝, 才	贝, 𠂇, ㇒	冂, 人, 𠂇, ㇒
睬	目, 采	目, 爫, 木	口, 二, 爫, 一, 丨, 八
踩	⻊, 采	⻊, 爫, 木	口, 丨, 一, 丨, 一, 爫, 一, 丨, 八
采	爫, 木	爫, 木	爫, 一, 丨, 八
彩	采, 彡	爫, 木, 彡	爫, 一, 丨, 八, 彡
菜	艹, 采	艹, 爫, 木	艹, 爫, 一, 丨, 八
蔡	艹, 祭	艹, 月, 卩, 示	艹, 冂, 二, 丨, ㇆, 二, 亅, 八
餐	𣦼, 食	歺, 又, 食	丨, 一, 夕, ㇇, ㇏, 人, 丶, 丨, ㇕, 二, 乚, 冫
参	No glyph available, 彡	厶, 大, 彡	㇛, 丶, 人, 一, 彡
蚕	天, 虫	一, 大, 虫	一, 人, 一, 口, 丨, 𠂉
残	歹, 戋	歹, 戋	一, 夕, 戋
惭	忄, 斩	忄, 车, 斤	丨, 八, 乚, 一, 一, 丨, 丿, ㇒, 一, 丨
惨	忄, 参	忄, 厶, 大, 彡	丨, 八, ㇛, 丶, 人, 一, 彡
灿	火, 山	火, 山	丿, 丶, 冫, 丨, 凵
苍	艹, 仓	艹, 人, 乚, ㇆	艹, 人, 乚, ㇆
舱	舟, 仓	舟, 人, 乚, ㇆	冂, 丶, ⺀, 一, 人, 乚, ㇆
仓	人, 㔾	人, 乚, ㇆	人, 乚, ㇆
沧	氵, 仓	氵, 人, 乚, ㇆	⺀, ㇀, 人, 乚, ㇆
藏	艹, 臧	艹, 爿, 厂, 戈, 臣	艹, 爿, 厂, 戈, 一, ㇗, 丨, 匚
操	扌, 喿	扌, 品, 木	亅, 二, 品, 一, 丨, 八
糙	米, 造	米, 辶, ⺧, 口	一, 丨, 八, 丷, 丶, ㇆, ㇝, ⺧, 口
槽	木, 曹	木, 艹, No glyph availabl, 二, 凵, 日	一, 丨, 八, 艹, 丨, 二, 凵, 口, 一
曹	No glyph available, 日	艹, No glyph availabl, 二, 凵, 日	艹, 丨, 二, 凵, 口, 一
草	艹, 早	艹, 日, 十	艹, 口, 一, 一, 丨
厕	厂, 则	厂, 贝, 刂	厂, 冂, 人, 亅, 丨
策	⺮, 朿	⺮, 木, 冂	⺮, 一, 丨, 八, 冂
侧	亻, 则	亻, 贝, 刂	㇒, 丨, 冂, 人, 亅, 丨
册	No glyph available	册	册
测	氵, 则	氵, 贝, 刂	⺀, ㇀, 冂, 人, 亅, 丨
层	尸, 云	尸, 二, 厶	丨, 匚, 二, ㇛, 丶
蹭	⻊, 曾	⻊, 丷, 口, 丨, 丷, 日	口, 丨, 一, 丨, 一, 丷, 口, 丨, 丷, 口, 一
插	扌, 臿	扌, ㇒, 十, 臼	亅, 二, ㇒, 一, 丨, 臼
叉	又, 丶	又, 丶	㇇, ㇏, 丶
茬	艹, 在	艹, 𠂇, 亻, 土	艹, 𠂇, ㇒, 丨, 一, 丨, 一
茶	艹, No glyph available	艹, 人, 十, 小	艹, 人, 一, 丨, 亅, 八
查	木, 旦	木, 日, 一	一, 丨, 八, 口, 一, 一
碴	石, 查	石, 木, 日, 一	一, 丿, 口, 一, 丨, 八, 口, 一, 一
搽	扌, 茶	扌, 艹, 人, 十, 小	亅, 二, 艹, 人, 一, 丨, 亅, 八
察	宀, 祭	宀, 月, 卩, 示	冖, 丶, 冂, 二, 丨, ㇆, 二, 亅, 八
岔	分, 山	八, 刀, 山	八, ㇆, 丿, 丨, 凵
差	羊, 工	羊, 工	一, 二, 丨, 丷, 一, 丨, 一
诧	讠, 宅	讠, 宀, ㇒, 乚, 一	㇊, 丶, 冖, 丶, ㇒, 乚, 一
拆	扌, 斥	扌, 斤, 丶	亅, 二, 丿, ㇒, 一, 丨, 丶
柴	此, 木	止, 匕, 木	丨, 一, 丨, 一, 乚, ㇒, 一, 丨, 八
豺	豸, 才	豸, 𠂇, ㇒	爫, ㇁, ㇒, 𠂇, ㇒
搀	扌, No glyph available	扌, ⺈, 口, 丨, 乚, ⺀	亅, 二, ⺈, 口, 丨, 乚, ⺀
掺	扌, 参	扌, 厶, 大, 彡	亅, 二, ㇛, 丶, 人, 一, 彡
蝉	虫, 单	虫, 丷, 冂, 二, 丨, 十	口, 丨, 𠂉, 丷, 冂, 二, 丨, 一, 丨
馋	饣, No glyph available	饣, ⺈, 口, 丨, 乚, ⺀	⺈, 乚, ⺈, 口, 丨, 乚, ⺀
谗	讠, No glyph available	讠, ⺈, 口, 丨, 乚, ⺀	㇊, 丶, ⺈, 口, 丨, 乚, ⺀
缠	纟, 㢆	纟, 广, 里	㇛, 一, 厂, 丶, 冂, 一, 丨, 一, 一, 丨, 一
铲	钅, 产	钅, 立, 厂	丿, 一, 乚, 二, 一, 丶, 丷, 一, 厂
产	立, 厂	立, 厂	一, 丶, 丷, 一, 厂
阐	门, 单	门, 丷, 冂, 二, 丨, 十	丶, 丨, ㇆, 丷, 冂, 二, 丨, 一, 丨
颤	亶, 页	亠, 回, 日, 一, 页	一, 丶, 回, 口, 一, 一, 一, 丿, 冂, 人
昌	日	昌	昌
猖	犭, 昌	犭, 昌	㇁, ㇒, 昌
场	土, 𠃓	土, ㇎, No glyph availabl	一, 丨, 一, ㇎, ㇒
尝	龸, 云	⺌, 冖, 二, 厶	丨, 丷, 冖, 二, ㇛, 丶
常	龸, 吊	⺌, 冖, 口, 巾	丨, 丷, 冖, 口, 冂, 丨
长	No glyph available, 一	长	乚, 冫, 一
偿	亻, 尝	亻, ⺌, 冖, 二, 厶	㇒, 丨, 丨, 丷, 冖, 二, ㇛, 丶
肠	月, 𠃓	月, ㇎, No glyph availabl	冂, 二, ㇎, ㇒
厂	㇕	厂	厂
敞	尚, ⺙	⺌, 冂, 口, ⺙	丨, 丷, 冂, 口, 丿, 一, 乂
畅	申, 𠃓	日, 丨, ㇎, No glyph availabl	口, 一, 丨, ㇎, ㇒
唱	口, 昌	口, 昌	口, 昌
倡	亻, 昌	亻, 昌	㇒, 丨, 昌
超	走, 召	走, 刀, 口	一, 丨, 一, 龰, ㇆, 丿, 口
抄	扌, 少	扌, 小, 丿	亅, 二, 亅, 八, 丿
钞	钅, 少	钅, 小, 丿	丿, 一, 乚, 二, 亅, 八, 丿
朝	龺, 月	十, 日, 十, 月	一, 丨, 口, 一, 一, 丨, 冂, 二
嘲	口, 朝	口, 十, 日, 十, 月	口, 一, 丨, 口, 一, 一, 丨, 冂, 二
潮	氵, 朝	氵, 十, 日, 十, 月	⺀, ㇀, 一, 丨, 口, 一, 一, 丨, 冂, 二
巢	巛, 果	巛, 田, 木	巛, 冂, 一, 丨, 一, 一, 丨, 八
吵	口, 少	口, 小, 丿	口, 亅, 八, 丿
炒	火, 少	火, 小, 丿	丿, 丶, 冫, 亅, 八, 丿
车	七, 十	车	乚, 一, 一, 丨
扯	扌, 止	扌, 止	亅, 二, 丨, 一, 丨, 一
撤	扌, No glyph available	扌, 亠, 厶, 月, ⺙	亅, 二, 一, 丶, ㇛, 丶, 冂, 二, 丿, 一, 乂
掣	制, 手	牛, 巾, 刂, 手	二, 丨, ㇒, 冂, 丨, 亅, 丨, ㇒, 亅, 二
彻	彳, 切	彳, 乚, 一, 刀	㇒, 丨, 乚, 一, ㇆, 丿
澈	氵, No glyph available	氵, 亠, 厶, 月, ⺙	⺀, ㇀, 一, 丶, ㇛, 丶, 冂, 二, 丿, 一, 乂
郴	林, 阝	林, 阝	林, 丨, ㇌
臣	匚, No glyph available	臣	一, ㇗, 丨, 匚
辰	厂, No glyph available	辰	厂, 二, 乚, 冫
尘	小, 土	小, 土	亅, 八, 一, 丨, 一
晨	日, 辰	日, 辰	口, 一, 厂, 二, 乚, 冫
忱	忄, 冘	忄, 巾, 乚	丨, 八, 冂, 丨, 乚
沉	氵, 冗	氵, 冖, 几	⺀, ㇀, 冖, 丿, ㇠
陈	阝, 东	阝, 乚, 一, 小	丨, ㇌, 乚, 一, 亅, 八
趁	走, 㐱	走, 人, 彡	一, 丨, 一, 龰, 人, 彡
衬	衤, 寸	衤, 寸	一, 一, 丨, 一, 丶, 戈, 丨, 冫, 𠂇, 亅, 丶
撑	扌, 掌	扌, ⺌, 冖, 口, 手	亅, 二, 丨, 丷, 冖, 口, ㇒, 亅, 二
称	禾, 尔	禾, ⺈, 小	㇒, 一, 丨, 八, ⺈, 亅, 八
城	土, 成	土, 一, 丿, ㇆, 戈	一, 丨, 一, 一, 丿, ㇆, 戈
橙	木, 登	木, 癶, 豆	一, 丨, 八, 癶, 一, 口, 丷, 一
成	万, 戈	一, 丿, ㇆, 戈	一, 丿, ㇆, 戈
呈	口, 王	口, 王	口, 一, 一, 丨, 一
乘	禾, 北	禾, 北	㇒, 一, 丨, 八, 北
程	禾, 呈	禾, 口, 王	㇒, 一, 丨, 八, 口, 一, 一, 丨, 一
惩	征, 心	彳, 一, 止, 心	㇒, 丨, 一, 丨, 一, 丨, 一, 𠁼, ㇃
澄	氵, 登	氵, 癶, 豆	⺀, ㇀, 癶, 一, 口, 丷, 一
诚	讠, 成	讠, 一, 丿, ㇆, 戈	㇊, 丶, 一, 丿, ㇆, 戈
承	氶, 三	㇖, 水, 一, 二	㇖, 亅, ㇇, 冫, 一, 二
逞	辶, 呈	辶, 口, 王	丶, ㇆, ㇝, 口, 一, 一, 丨, 一
骋	马, 甹	马, 二, 丨, 凵, 一, ㇉	㇕, ㇉, 一, 二, 丨, 凵, 一, ㇉
秤	禾, 平	禾, 干, 丷	㇒, 一, 丨, 八, 一, 一, 丨, 丷
吃	口, 乞	口, 丿, 一, ㇠	口, 丿, 一, ㇠
痴	疒, 知	疒, 矢, 口	一, 丶, 厂, 丶, 丿, 一, 人, 一, 口
持	扌, 寺	扌, 土, 寸	亅, 二, 一, 丨, 一, 𠂇, 亅, 丶
匙	是, 匕	日, 一, 龰, 匕	口, 一, 一, 龰, 乚, ㇒
池	氵, 也	氵, 乚, ㇆, 丨	⺀, ㇀, 乚, ㇆, 丨
迟	辶, 尺	辶, 尸, ㇏	丶, ㇆, ㇝, 丨, 匚, ㇏
弛	弓, 也	弓, 乚, ㇆, 丨	匚, ㇉, 乚, ㇆, 丨
驰	马, 也	马, 乚, ㇆, 丨	㇕, ㇉, 一, 乚, ㇆, 丨
耻	耳, 止	耳, 止	二, 丨, 二, 丨, 一, 丨, 一
齿	止, No glyph available	齿	丨, 一, 丨, 一, 凵, 人
侈	亻, 多	亻, 多	㇒, 丨, 多
尺	尸, ㇏	尸, ㇏	丨, 匚, ㇏
赤	土, No glyph available	赤	一, 丨, 一, 丨, 亅, 八
翅	支, 羽	支, 羽	一, 丨, ㇇, ㇏, 羽
斥	斤, 丶	斤, 丶	丿, ㇒, 一, 丨, 丶
炽	火, 只	火, 口, 八	丿, 丶, 冫, 口, 八
充	亠, 允	亠, 厶, 儿	一, 丶, ㇛, 丶, 丿, 乚
冲	冫, 中	冫, 口, 丨	丶, ㇀, 口, 丨
虫	中, No glyph available	虫	口, 丨, 𠂉
崇	山, 宗	山, 宀, 示	丨, 凵, 冖, 丶, 二, 亅, 八
宠	宀, 龙	宀, 龙	冖, 丶, 𠂇, 丶, 乚, ㇒
抽	扌, 由	扌, 二, 丨, 凵	亅, 二, 二, 丨, 凵
酬	酉, 州	酉, 州	一, 丿, 乚, 口, 一, 州
畴	田, 寿	田, 一, 二, 丨, 寸	冂, 一, 丨, 一, 一, 二, 丨, 𠂇, 亅, 丶
踌	⻊, 寿	⻊, 一, 二, 丨, 寸	口, 丨, 一, 丨, 一, 一, 二, 丨, 𠂇, 亅, 丶
稠	禾, 周	禾, 田, 口	㇒, 一, 丨, 八, 冂, 一, 丨, 一, 口
愁	秋, 心	禾, 火, 心	㇒, 一, 丨, 八, 丿, 丶, 冫, 𠁼, ㇃
筹	⺮, 寿	⺮, 一, 二, 丨, 寸	⺮, 一, 二, 丨, 𠂇, 亅, 丶
仇	亻, 九	亻, 丿, ㇈	㇒, 丨, 丿, ㇈
绸	纟, 周	纟, 田, 口	㇛, 一, 冂, 一, 丨, 一, 口
瞅	目, 秋	目, 禾, 火	口, 二, ㇒, 一, 丨, 八, 丿, 丶, 冫
丑	刀, 二	刀, 二	㇆, 丿, 二
臭	自, 犬	自, 犬	口, 二, 丶, 人, 一, 丶
初	衤, 刀	衤, 刀	一, 一, 丨, 一, 丶, 戈, 丨, 冫, ㇆, 丿
出	山	出	出
橱	木, 厨	木, 厂, 豆, 寸	一, 丨, 八, 厂, 一, 口, 丷, 一, 𠂇, 亅, 丶
厨	厂, No glyph available	厂, 豆, 寸	厂, 一, 口, 丷, 一, 𠂇, 亅, 丶
躇	⻊, 著	⻊, 艹, 耂, 日	口, 丨, 一, 丨, 一, 艹, 耂, 口, 一
锄	钅, 助	钅, 月, 一, 力	丿, 一, 乚, 二, 冂, 二, 一, ㇆, 丿
雏	刍, 隹	⺈, 彐, 隹	⺈, ㇕, 二, ㇒, 丨, 一, 二, 丨, 一, 丶
滁	氵, 除	氵, 阝, 人, 干, 小	⺀, ㇀, 丨, ㇌, 人, 一, 一, 丨, 亅, 八
除	阝, 余	阝, 人, 干, 小	丨, ㇌, 人, 一, 一, 丨, 亅, 八
楚	林, 疋	林, 疋	林, ㇖, 龰
础	石, 出	石, 出	一, 丿, 口, 出
储	亻, 诸	亻, 讠, 耂, 日	㇒, 丨, ㇊, 丶, 耂, 口, 一
矗	直	矗	矗
搐	扌, 畜	扌, 玄, 田	亅, 二, 一, 丶, ㇛, 丶, 冂, 一, 丨, 一
触	角, 虫	角, 虫	⺈, 冂, 二, 丨, 口, 丨, 𠂉
处	夂, 卜	夂, 卜	㇇, ㇏, ㇒, 丨, 丶
揣	扌, 耑	扌, 山, 而	亅, 二, 丨, 凵, 一, 丿, 冂, 丨
川	丨	川	川
穿	穴, 牙	穴, 牙	冖, 丶, 八, 一, 丨, ㇜, 亅, 丿
椽	木, 彖	木, 彑, 勹, No glyph availabl, No glyph availabl	一, 丨, 八, ㇗, ㇕, 一, ㇆, ㇒, ㇒, 冫
传	亻, 专	亻, 二, 丨, 龴	㇒, 丨, 二, 丨, 龴
船	舟, No glyph available	舟, 几, 口	冂, 丶, ⺀, 一, 丿, ㇠, 口
喘	口, 耑	口, 山, 而	口, 丨, 凵, 一, 丿, 冂, 丨
串	中	串	串
疮	疒, 仓	疒, 人, 乚, ㇆	一, 丶, 厂, 丶, 人, 乚, ㇆
窗	穴, 囱	穴, 囗, 丶, 夂	冖, 丶, 八, 冂, 一, 丶, ㇇, ㇏, ㇒
幢	巾, 童	巾, 立, 里	冂, 丨, 一, 丶, 丷, 一, 冂, 一, 丨, 一, 一, 丨, 一
床	广, 木	广, 木	厂, 丶, 一, 丨, 八
闯	门, 马	门, 马	丶, 丨, ㇆, ㇕, ㇉, 一
创	仓, 刂	人, 乚, ㇆, 刂	人, 乚, ㇆, 亅, 丨
吹	口, 欠	口, 欠	口, ⺈, 人
炊	火, 欠	火, 欠	丿, 丶, 冫, ⺈, 人
捶	扌, 垂	扌, ㇒, 十, 士, 艹	亅, 二, ㇒, 一, 丨, 一, 丨, 一, 艹
锤	钅, 垂	钅, ㇒, 十, 士, 艹	丿, 一, 乚, 二, ㇒, 一, 丨, 一, 丨, 一, 艹
垂	No glyph available, 艹	㇒, 十, 士, 艹	㇒, 一, 丨, 一, 丨, 一, 艹
春	𡗗, 日	一, 二, 丨, 八, 日	一, 二, 丨, 八, 口, 一
椿	木, 春	木, 一, 二, 丨, 八, 日	一, 丨, 八, 一, 二, 丨, 八, 口, 一
醇	酉, 享	酉, 亠, 口, 子	一, 丿, 乚, 口, 一, 一, 丶, 口, ㇇, 亅, 一
唇	辰, 口	辰, 口	厂, 二, 乚, 冫, 口
淳	氵, 享	氵, 亠, 口, 子	⺀, ㇀, 一, 丶, 口, ㇇, 亅, 一
纯	纟, 屯	纟, 十, 屮, 乚	㇛, 一, 一, 丨, 丨, 凵, 乚
蠢	春, 䖵	一, 二, 丨, 八, 日, 䖵	一, 二, 丨, 八, 口, 一, 䖵
戳	翟, 戈	羽, 隹, 戈	羽, ㇒, 丨, 一, 二, 丨, 一, 丶, 戈
绰	纟, 卓	纟, ⺊, 日, 十	㇛, 一, 丨, 一, 口, 一, 一, 丨
疵	疒, 此	疒, 止, 匕	一, 丶, 厂, 丶, 丨, 一, 丨, 一, 乚, ㇒
茨	艹, 次	艹, 冫, 欠	艹, 丶, ㇀, ⺈, 人
磁	石, 兹	石, 丷, 一, 𢆶	一, 丿, 口, 丷, 一, 𢆶
雌	此, 隹	止, 匕, 隹	丨, 一, 丨, 一, 乚, ㇒, ㇒, 丨, 一, 二, 丨, 一, 丶
辞	舌, 辛	舌, 辛	㇒, 一, 丨, 口, 一, 丶, 丷, 一, 一, 丨
慈	兹, 心	丷, 一, 𢆶, 心	丷, 一, 𢆶, 𠁼, ㇃
瓷	次, 瓦	冫, 欠, 瓦	丶, ㇀, ⺈, 人, 匸, ㇈, 丶
词	讠, 司	讠, ㇆, 一, 口	㇊, 丶, ㇆, 一, 口
此	止, 匕	止, 匕	丨, 一, 丨, 一, 乚, ㇒
刺	朿, 刂	木, 冂, 刂	一, 丨, 八, 冂, 亅, 丨
赐	贝, 易	贝, 日, 勹, No glyph availabl	冂, 人, 口, 一, ㇆, ㇒, ㇒
次	冫, 欠	冫, 欠	丶, ㇀, ⺈, 人
聪	耳, 总	耳, 丷, 口, 心	二, 丨, 二, 丷, 口, 𠁼, ㇃
葱	艹, 怱	艹, 勹, No glyph availabl, 丶, 心	艹, ㇆, ㇒, ㇒, 丶, 𠁼, ㇃
囱	No glyph available, 夂	囗, 丶, 夂	冂, 一, 丶, ㇇, ㇏, ㇒
匆	勿, 丶	勹, No glyph availabl, 丶	㇆, ㇒, ㇒, 丶
从	人	从	从
丛	从, 一	从, 一	从, 一
凑	冫, No glyph available	冫, 一, 二, 丨, 八, ㇒, 大	丶, ㇀, 一, 二, 丨, 八, ㇒, 人, 一
粗	米, 且	米, 月, 一	一, 丨, 八, 丷, 冂, 二, 一
醋	酉, 昔	酉, 艹, 一, 日	一, 丿, 乚, 口, 一, 艹, 一, 口, 一
簇	⺮, 族	⺮, 方, 丿, 一, 矢	⺮, 一, 丶, 丿, ㇆, 丿, 一, 丿, 一, 人, 一
促	亻, 足	亻, 足	㇒, 丨, 口, 龰
蹿	⻊, 窜	⻊, 穴, 串	口, 丨, 一, 丨, 一, 冖, 丶, 八, 串
篡	⺮, No glyph available	⺮, 目, 大, 厶	⺮, 口, 二, 人, 一, ㇛, 丶
窜	穴, 串	穴, 串	冖, 丶, 八, 串
摧	扌, 崔	扌, 山, 隹	亅, 二, 丨, 凵, ㇒, 丨, 一, 二, 丨, 一, 丶
崔	山, 隹	山, 隹	丨, 凵, ㇒, 丨, 一, 二, 丨, 一, 丶
催	亻, 崔	亻, 山, 隹	㇒, 丨, 丨, 凵, ㇒, 丨, 一, 二, 丨, 一, 丶
脆	月, 危	月, ⺈, 厂, 乚, ㇆	冂, 二, ⺈, 厂, 乚, ㇆
瘁	疒, 卒	疒, 亠, 从, 十	一, 丶, 厂, 丶, 一, 丶, 从, 一, 丨
粹	米, 卒	米, 亠, 从, 十	一, 丨, 八, 丷, 一, 丶, 从, 一, 丨
淬	氵, 卒	氵, 亠, 从, 十	⺀, ㇀, 一, 丶, 从, 一, 丨
翠	羽, 卒	羽, 亠, 从, 十	羽, 一, 丶, 从, 一, 丨
村	木, 寸	木, 寸	一, 丨, 八, 𠂇, 亅, 丶
存	𠂇, 仔	𠂇, 亻, 子	𠂇, ㇒, 丨, ㇇, 亅, 一
寸	No glyph available, 丶	寸	𠂇, 亅, 丶
磋	石, 差	石, 羊, 工	一, 丿, 口, 一, 二, 丨, 丷, 一, 丨, 一
撮	扌, 最	扌, 曰, 耳, 又	亅, 二, 口, 一, 二, 丨, 二, ㇇, ㇏
搓	扌, 差	扌, 羊, 工	亅, 二, 一, 二, 丨, 丷, 一, 丨, 一
措	扌, 昔	扌, 艹, 一, 日	亅, 二, 艹, 一, 口, 一
挫	扌, 坐	扌, 土, 从	亅, 二, 一, 丨, 一, 从
错	钅, 昔	钅, 艹, 一, 日	丿, 一, 乚, 二, 艹, 一, 口, 一
搭	扌, 荅	扌, 艹, 人, 一, 口	亅, 二, 艹, 人, 一, 口
达	辶, 大	辶, 大	丶, ㇆, ㇝, 人, 一
答	⺮, 合	⺮, 人, 一, 口	⺮, 人, 一, 口
瘩	疒, 荅	疒, 艹, 人, 一, 口	一, 丶, 厂, 丶, 艹, 人, 一, 口
打	扌, 丁	扌, 一, 亅	亅, 二, 一, 亅
大	人, 一	大	人, 一
呆	口, 木	口, 木	口, 一, 丨, 八
歹	一, 夕	歹	一, 夕
傣	亻, 泰	亻, 一, 二, 丨, 八, 氺	㇒, 丨, 一, 二, 丨, 八, 亅, 丶, ㇀, 冫
戴	𢦏, 異	土, 戈, 田, 艹, 一, 八	一, 丨, 一, 戈, 冂, 一, 丨, 一, 艹, 一, 八
带	卅, No glyph available	川, 一, 冖, 巾	川, 一, 冖, 冂, 丨
殆	歹, 台	歹, 厶, 口	一, 夕, ㇛, 丶, 口
代	亻, 弋	亻, 弋	㇒, 丨, 弋
贷	代, 贝	亻, 弋, 贝	㇒, 丨, 弋, 冂, 人
袋	代, 衣	亻, 弋, 衣	㇒, 丨, 弋, 一, 丶, ㇒, ㇗, 冫
待	彳, 寺	彳, 土, 寸	㇒, 丨, 一, 丨, 一, 𠂇, 亅, 丶
逮	辶, 隶	辶, 隶	丶, ㇆, ㇝, 匚, 一, 丨, 亅, 丶, ㇀, 冫
怠	台, 心	厶, 口, 心	㇛, 丶, 口, 𠁼, ㇃
耽	耳, 冘	耳, 巾, 乚	二, 丨, 二, 冂, 丨, 乚
担	扌, 旦	扌, 日, 一	亅, 二, 口, 一, 一
丹	冂, 亠	冂, 亠	冂, 一, 丶
单	丷, No glyph available	丷, 冂, 二, 丨, 十	丷, 冂, 二, 丨, 一, 丨
郸	单, 阝	丷, 冂, 二, 丨, 十, 阝	丷, 冂, 二, 丨, 一, 丨, 丨, ㇌
掸	扌, 单	扌, 丷, 冂, 二, 丨, 十	亅, 二, 丷, 冂, 二, 丨, 一, 丨
胆	月, 旦	月, 日, 一	冂, 二, 口, 一, 一
旦	日, 一	日, 一	口, 一, 一
氮	气, 炎	气, 炎	丿, 一, 一, ㇠, 炎
但	亻, 旦	亻, 日, 一	㇒, 丨, 口, 一, 一
惮	忄, 单	忄, 丷, 冂, 二, 丨, 十	丨, 八, 丷, 冂, 二, 丨, 一, 丨
淡	氵, 炎	氵, 炎	⺀, ㇀, 炎
诞	讠, 延	讠, 廴, ㇒, 止	㇊, 丶, ㇋, ㇏, ㇒, 丨, 一, 丨, 一
弹	弓, 单	弓, 丷, 冂, 二, 丨, 十	匚, ㇉, 丷, 冂, 二, 丨, 一, 丨
蛋	疋, 虫	疋, 虫	㇖, 龰, 口, 丨, 𠂉
当	⺌, 彐	⺌, 彐	丨, 丷, ㇕, 二
挡	扌, 当	扌, ⺌, 彐	亅, 二, 丨, 丷, ㇕, 二
党	龸, 兄	⺌, 冖, 口, 儿	丨, 丷, 冖, 口, 丿, 乚
荡	艹, 汤	艹, 氵, ㇎, No glyph availabl	艹, ⺀, ㇀, ㇎, ㇒
档	木, 当	木, ⺌, 彐	一, 丨, 八, 丨, 丷, ㇕, 二
刀	㇆, 丿	刀	㇆, 丿
捣	扌, 岛	扌, ㇆, ㇉, 丶, 丶, 山	亅, 二, ㇆, ㇉, 丶, 丶, 丨, 凵
蹈	⻊, 舀	⻊, 爫, 臼	口, 丨, 一, 丨, 一, 爫, 臼
倒	亻, 到	亻, 至, 刂	㇒, 丨, 一, ㇛, 丶, 一, 丨, 一, 亅, 丨
岛	No glyph available, 山	㇆, ㇉, 丶, 丶, 山	㇆, ㇉, 丶, 丶, 丨, 凵
祷	礻, 寿	礻, 一, 二, 丨, 寸	一, 一, 丨, 一, 丶, 戈, 丨, 丶, 一, 二, 丨, 𠂇, 亅, 丶
导	巳, 寸	巳, 寸	丨, 匚, 乚, 𠂇, 亅, 丶
到	至, 刂	至, 刂	一, ㇛, 丶, 一, 丨, 一, 亅, 丨
稻	禾, 舀	禾, 爫, 臼	㇒, 一, 丨, 八, 爫, 臼
悼	忄, 卓	忄, ⺊, 日, 十	丨, 八, 丨, 一, 口, 一, 一, 丨
道	辶, 首	辶, 首	丶, ㇆, ㇝, 丷, 一, 口, 二, 丶
盗	次, 皿	冫, 欠, 皿	丶, ㇀, ⺈, 人, 冂, 丨, 一
德	彳, 𢛳	彳, 𢛳	㇒, 丨, 𢛳
得	彳, 㝵	彳, 日, 一, 寸	㇒, 丨, 口, 一, 一, 𠂇, 亅, 丶
的	白, 勺	白, 勹, 丶	口, 一, ㇒, ㇆, ㇒, 丶
蹬	⻊, 登	⻊, 癶, 豆	口, 丨, 一, 丨, 一, 癶, 一, 口, 丷, 一
灯	火, 丁	火, 一, 亅	丿, 丶, 冫, 一, 亅
登	癶, 豆	癶, 豆	癶, 一, 口, 丷, 一
等	⺮, 寺	⺮, 土, 寸	⺮, 一, 丨, 一, 𠂇, 亅, 丶
瞪	目, 登	目, 癶, 豆	口, 二, 癶, 一, 口, 丷, 一
凳	癶, No glyph available	癶, 一, 口, 丷, 一, 几	癶, 一, 口, 丷, 一, 丿, ㇠
邓	又, 阝	又, 阝	㇇, ㇏, 丨, ㇌
堤	土, 是	土, 日, 一, 龰	一, 丨, 一, 口, 一, 一, 龰
低	亻, 氐	亻, 氏, 丶	㇒, 丨, ㇒, ㇗, ㇂, 一, 丶
滴	氵, 啇	氵, 亠, 丷, 欠, 子	⺀, ㇀, 一, 丶, 丷, ⺈, 人, ㇇, 亅, 一
迪	辶, 由	辶, 二, 丨, 凵	丶, ㇆, ㇝, 二, 丨, 凵
敌	舌, ⺙	舌, ⺙	㇒, 一, 丨, 口, 丿, 一, 乂
笛	⺮, 由	⺮, 二, 丨, 凵	⺮, 二, 丨, 凵
狄	犭, 火	犭, 火	㇁, ㇒, 丿, 丶, 冫
涤	氵, 条	氵, 夂, 十, 小	⺀, ㇀, ㇇, ㇏, ㇒, 一, 丨, 亅, 八
翟	羽, 隹	羽, 隹	羽, ㇒, 丨, 一, 二, 丨, 一, 丶
嫡	女, 啇	女, 亠, 丷, 欠, 子	㇛, 一, 丿, 一, 丶, 丷, ⺈, 人, ㇇, 亅, 一
抵	扌, 氐	扌, 氏, 丶	亅, 二, ㇒, ㇗, ㇂, 一, 丶
底	广, 氐	广, 氏, 丶	厂, 丶, ㇒, ㇗, ㇂, 一, 丶
地	土, 也	土, 乚, ㇆, 丨	一, 丨, 一, 乚, ㇆, 丨
蒂	艹, 帝	艹, 亠, 丷, 冖, 巾	艹, 一, 丶, 丷, 冖, 冂, 丨
第	⺮, 𢎨	⺮, 弓, 丨, ㇒	⺮, 匚, ㇉, 丨, ㇒
帝	No glyph available, 巾	亠, 丷, 冖, 巾	一, 丶, 丷, 冖, 冂, 丨
弟	丷, 𢎨	丷, 弓, 丨, ㇒	丷, 匚, ㇉, 丨, ㇒
递	辶, 弟	辶, 丷, 弓, 丨, ㇒	丶, ㇆, ㇝, 丷, 匚, ㇉, 丨, ㇒
缔	纟, 帝	纟, 亠, 丷, 冖, 巾	㇛, 一, 一, 丶, 丷, 冖, 冂, 丨
颠	真, 页	十, 目, 一, 八, 页	一, 丨, 口, 二, 一, 八, 一, 丿, 冂, 人
掂	扌, 店	扌, 广, ⺊, 口	亅, 二, 厂, 丶, 丨, 一, 口
滇	氵, 真	氵, 十, 目, 一, 八	⺀, ㇀, 一, 丨, 口, 二, 一, 八
碘	石, 典	石, No glyph availabl, 二, 凵, 八	一, 丿, 口, 丨, 二, 凵, 八
点	占, 灬	⺊, 口, 灬	丨, 一, 口, 灬
典	曲, 八	No glyph availabl, 二, 凵, 八	丨, 二, 凵, 八
靛	青, 定	青, 宀, 一, 龰	龶, 冂, 二, 冖, 丶, 一, 龰
垫	执, 土	扌, 丿, ㇈, 丶, 土	亅, 二, 丿, ㇈, 丶, 一, 丨, 一
电	申, 乚	日, 丨, 乚	口, 一, 丨, 乚
佃	亻, 田	亻, 田	㇒, 丨, 冂, 一, 丨, 一
甸	勹, 田	勹, 田	㇆, ㇒, 冂, 一, 丨, 一
店	广, 占	广, ⺊, 口	厂, 丶, 丨, 一, 口
惦	忄, 店	忄, 广, ⺊, 口	丨, 八, 厂, 丶, 丨, 一, 口
奠	酋, 大	丷, 酉, 大	丷, 一, 丿, 乚, 口, 一, 人, 一
淀	氵, 定	氵, 宀, 一, 龰	⺀, ㇀, 冖, 丶, 一, 龰
殿	𡱒, 殳	尸, 艹, 一, 八, 殳	丨, 匚, 艹, 一, 八, 丿, ㇠, ㇇, ㇏
碉	石, 周	石, 田, 口	一, 丿, 口, 冂, 一, 丨, 一, 口
叼	口, 刁	口, ㇆, ㇀	口, ㇆, ㇀
雕	周, 隹	田, 口, 隹	冂, 一, 丨, 一, 口, ㇒, 丨, 一, 二, 丨, 一, 丶
凋	冫, 周	冫, 田, 口	丶, ㇀, 冂, 一, 丨, 一, 口
刁	㇆, ㇀	㇆, ㇀	㇆, ㇀
掉	扌, 卓	扌, ⺊, 日, 十	亅, 二, 丨, 一, 口, 一, 一, 丨
吊	口, 巾	口, 巾	口, 冂, 丨
钓	钅, 勺	钅, 勹, 丶	丿, 一, 乚, 二, ㇆, ㇒, 丶
调	讠, 周	讠, 田, 口	㇊, 丶, 冂, 一, 丨, 一, 口
跌	⻊, 失	⻊, 人, 二, ㇒	口, 丨, 一, 丨, 一, 人, 二, ㇒
爹	父, 多	父, 多	八, 乂, 多
碟	石, 枼	石, ㇗, 廿, 木	一, 丿, 口, ㇗, 卄, 一, 一, 丨, 八
蝶	虫, 枼	虫, ㇗, 廿, 木	口, 丨, 𠂉, ㇗, 卄, 一, 一, 丨, 八
迭	辶, 失	辶, 人, 二, ㇒	丶, ㇆, ㇝, 人, 二, ㇒
谍	讠, 枼	讠, ㇗, 廿, 木	㇊, 丶, ㇗, 卄, 一, 一, 丨, 八
叠	叒, 冝	叒, 冖, 月, 一	叒, 冖, 冂, 二, 一
丁	一, 亅	一, 亅	一, 亅
盯	目, 丁	目, 一, 亅	口, 二, 一, 亅
叮	口, 丁	口, 一, 亅	口, 一, 亅
钉	钅, 丁	钅, 一, 亅	丿, 一, 乚, 二, 一, 亅
顶	丁, 页	一, 亅, 页	一, 亅, 一, 丿, 冂, 人
鼎	𤕰, 目	鼎	𤕰, 口, 二
锭	钅, 定	钅, 宀, 一, 龰	丿, 一, 乚, 二, 冖, 丶, 一, 龰
定	宀, 𤴓	宀, 一, 龰	冖, 丶, 一, 龰
订	讠, 丁	讠, 一, 亅	㇊, 丶, 一, 亅
丢	壬, 厶	㇒, 士, 厶	㇒, 一, 丨, 一, ㇛, 丶
东	七, 小	乚, 一, 小	乚, 一, 亅, 八
冬	夂, ⺀	夂, ⺀	㇇, ㇏, ㇒, ⺀
董	艹, 重	艹, ㇒, 十, 里	艹, ㇒, 一, 丨, 冂, 一, 丨, 一, 一, 丨, 一
懂	忄, 董	忄, 艹, ㇒, 十, 里	丨, 八, 艹, ㇒, 一, 丨, 冂, 一, 丨, 一, 一, 丨, 一
动	云, 力	二, 厶, 力	二, ㇛, 丶, ㇆, 丿
栋	木, 东	木, 乚, 一, 小	一, 丨, 八, 乚, 一, 亅, 八
侗	亻, 同	亻, 冂, 一, 口	㇒, 丨, 冂, 一, 口
恫	忄, 同	忄, 冂, 一, 口	丨, 八, 冂, 一, 口
冻	冫, 东	冫, 乚, 一, 小	丶, ㇀, 乚, 一, 亅, 八
洞	氵, 同	氵, 冂, 一, 口	⺀, ㇀, 冂, 一, 口
兜	No glyph available, 儿	㇒, ㇗, No glyph availabl, 白, 儿	㇒, ㇗, 匚, 口, 一, ㇒, 丿, 乚
抖	扌, 斗	扌, 斗	亅, 二, 一, 丨, ⺀
斗	十, ⺀	斗	一, 丨, ⺀
陡	阝, 走	阝, 走	丨, ㇌, 一, 丨, 一, 龰
豆	𠮛, 䒑	豆	一, 口, 丷, 一
逗	辶, 豆	辶, 豆	丶, ㇆, ㇝, 一, 口, 丷, 一
痘	疒, 豆	疒, 豆	一, 丶, 厂, 丶, 一, 口, 丷, 一
都	者, 阝	耂, 日, 阝	耂, 口, 一, 丨, ㇌
督	叔, 目	⺊, 一, 小, 又, 目	丨, 一, 一, 亅, 八, ㇇, ㇏, 口, 二
毒	龶, 母	龶, 母	龶, ㇗, ㇆, ⺀, 一
犊	牛, 卖	牛, 十, ㇖, 大, ⺀	二, 丨, ㇒, 一, 丨, ㇖, 人, 一, ⺀
独	犭, 虫	犭, 虫	㇁, ㇒, 口, 丨, 𠂉
读	讠, 卖	讠, 十, ㇖, 大, ⺀	㇊, 丶, 一, 丨, ㇖, 人, 一, ⺀
堵	土, 者	土, 耂, 日	一, 丨, 一, 耂, 口, 一
睹	目, 者	目, 耂, 日	口, 二, 耂, 口, 一
赌	贝, 者	贝, 耂, 日	冂, 人, 耂, 口, 一
杜	木, 土	木, 土	一, 丨, 八, 一, 丨, 一
镀	钅, 度	钅, 广, 廿, 又	丿, 一, 乚, 二, 厂, 丶, 卄, 一, ㇇, ㇏
肚	月, 土	月, 土	冂, 二, 一, 丨, 一
度	No glyph available, 又	广, 廿, 又	厂, 丶, 卄, 一, ㇇, ㇏
渡	氵, 度	氵, 广, 廿, 又	⺀, ㇀, 厂, 丶, 卄, 一, ㇇, ㇏
妒	女, 户	女, 户	㇛, 一, 丿, 丨, 匚, 丶
端	立, 耑	立, 山, 而	一, 丶, 丷, 一, 丨, 凵, 一, 丿, 冂, 丨
短	矢, 豆	矢, 豆	丿, 一, 人, 一, 一, 口, 丷, 一
锻	钅, 段	钅, 丨, No glyph availabl, 殳	丿, 一, 乚, 二, 丨, 一, 丿, ㇠, ㇇, ㇏
段	No glyph available, 殳	丨, No glyph availabl, 殳	丨, 一, 丿, ㇠, ㇇, ㇏
断	No glyph available, 斤	㇗, 米, 斤	㇗, 一, 丨, 八, 丷, 丿, ㇒, 一, 丨
缎	纟, 段	纟, 丨, No glyph availabl, 殳	㇛, 一, 丨, 一, 丿, ㇠, ㇇, ㇏
堆	土, 隹	土, 隹	一, 丨, 一, ㇒, 丨, 一, 二, 丨, 一, 丶
兑	丷, 兄	丷, 口, 儿	丷, 口, 丿, 乚
队	阝, 人	阝, 人	丨, ㇌, 人
对	又, 寸	又, 寸	㇇, ㇏, 𠂇, 亅, 丶
墩	土, 敦	土, 亠, 口, 子, ⺙	一, 丨, 一, 一, 丶, 口, ㇇, 亅, 一, 丿, 一, 乂
吨	口, 屯	口, 十, 屮, 乚	口, 一, 丨, 丨, 凵, 乚
蹲	⻊, 尊	⻊, 丷, 酉, 寸	口, 丨, 一, 丨, 一, 丷, 一, 丿, 乚, 口, 一, 𠂇, 亅, 丶
敦	享, ⺙	亠, 口, 子, ⺙	一, 丶, 口, ㇇, 亅, 一, 丿, 一, 乂
顿	屯, 页	十, 屮, 乚, 页	一, 丨, 丨, 凵, 乚, 一, 丿, 冂, 人
囤	囗, 屯	囗, 十, 屮, 乚	冂, 一, 一, 丨, 丨, 凵, 乚
钝	钅, 屯	钅, 十, 屮, 乚	丿, 一, 乚, 二, 一, 丨, 丨, 凵, 乚
盾	⺁, 𥃭	⺁, 十, 目	丿, ㇒, 一, 丨, 口, 二
遁	辶, 盾	辶, ⺁, 十, 目	丶, ㇆, ㇝, 丿, ㇒, 一, 丨, 口, 二
掇	扌, 叕	扌, 叕	亅, 二, 叕
哆	口, 多	口, 多	口, 多
多	夕	多	多
夺	大, 寸	大, 寸	人, 一, 𠂇, 亅, 丶
垛	土, 朵	土, 几, 木	一, 丨, 一, 丿, ㇠, 一, 丨, 八
躲	身, 朵	身, 几, 木	𠂎, 丶, 二, 丿, 丿, ㇠, 一, 丨, 八
朵	几, 木	几, 木	丿, ㇠, 一, 丨, 八
跺	⻊, 朵	⻊, 几, 木	口, 丨, 一, 丨, 一, 丿, ㇠, 一, 丨, 八
舵	舟, 它	舟, 宀, 匕	冂, 丶, ⺀, 一, 冖, 丶, 乚, ㇒
剁	朵, 刂	几, 木, 刂	丿, ㇠, 一, 丨, 八, 亅, 丨
惰	忄, No glyph available	忄, 𠂇, 工, 月	丨, 八, 𠂇, 一, 丨, 一, 冂, 二
堕	陏, 土	阝, 𠂇, 月, 土	丨, ㇌, 𠂇, 冂, 二, 一, 丨, 一
蛾	虫, 我	虫, 手, 戈	口, 丨, 𠂉, ㇒, 亅, 二, 戈
峨	山, 我	山, 手, 戈	丨, 凵, ㇒, 亅, 二, 戈
鹅	我, 鸟	手, 戈, 鸟	㇒, 亅, 二, 戈, ㇆, ㇉, 丶, 丶, 一
俄	亻, 我	亻, 手, 戈	㇒, 丨, ㇒, 亅, 二, 戈
额	客, 页	宀, 夂, 口, 页	冖, 丶, ㇇, ㇏, ㇒, 口, 一, 丿, 冂, 人
讹	讠, 化	讠, 亻, 匕	㇊, 丶, ㇒, 丨, 乚, ㇒
娥	女, 我	女, 手, 戈	㇛, 一, 丿, ㇒, 亅, 二, 戈
恶	亚, 心	一, No glyph availabl, 丷, 一, 心	一, 丨, 丷, 一, 𠁼, ㇃
厄	厂, 㔾	厂, 乚, ㇆	厂, 乚, ㇆
扼	扌, 厄	扌, 厂, 乚, ㇆	亅, 二, 厂, 乚, ㇆
遏	辶, 曷	辶, 曰, 勹, 人, ㇗	丶, ㇆, ㇝, 口, 一, ㇆, ㇒, 人, ㇗
鄂	咢, 阝	吅, 二, ㇉, 阝	吅, 二, ㇉, 丨, ㇌
饿	饣, 我	饣, 手, 戈	⺈, 乚, ㇒, 亅, 二, 戈
恩	因, 心	囗, 大, 心	冂, 一, 人, 一, 𠁼, ㇃
而	丆, 𦉫	而	一, 丿, 冂, 丨
儿	丿, 乚	儿	丿, 乚
耳	㔿, 二	耳	二, 丨, 二
尔	⺈, 小	⺈, 小	⺈, 亅, 八
饵	饣, 耳	饣, 耳	⺈, 乚, 二, 丨, 二
洱	氵, 耳	氵, 耳	⺀, ㇀, 二, 丨, 二
二	一	二	二
贰	弍, 贝	弋, 二, 贝	弋, 二, 冂, 人
发	No glyph available, 又	㇗, 丨, 丶, 又	㇗, 丨, 丶, ㇇, ㇏
罚	罒, No glyph available	罒, 讠, 刂	口, 丨, ㇊, 丶, 亅, 丨
筏	⺮, 伐	⺮, 亻, 戈	⺮, ㇒, 丨, 戈
伐	亻, 戈	亻, 戈	㇒, 丨, 戈
乏	㇒, 之	㇒, 王, 丶, 戈, ㇝	㇒, 一, 一, 丨, 一, 丶, 戈, ㇝
阀	门, 伐	门, 亻, 戈	丶, 丨, ㇆, ㇒, 丨, 戈
法	氵, 去	氵, 土, 厶	⺀, ㇀, 一, 丨, 一, ㇛, 丶
珐	王, 去	王, 土, 厶	一, 一, 丨, 一, 一, 丨, 一, ㇛, 丶
藩	艹, 潘	艹, 氵, 釆, 田	艹, ⺀, ㇀, ㇒, 一, 丨, 八, 丷, 冂, 一, 丨, 一
帆	巾, 凡	巾, 几, 丶	冂, 丨, 丿, ㇠, 丶
番	釆, 田	釆, 田	㇒, 一, 丨, 八, 丷, 冂, 一, 丨, 一
翻	番, 羽	釆, 田, 羽	㇒, 一, 丨, 八, 丷, 冂, 一, 丨, 一, 羽
樊	棥, 大	林, 爻, 大	林, 爻, 人, 一
矾	石, 凡	石, 几, 丶	一, 丿, 口, 丿, ㇠, 丶
钒	钅, 凡	钅, 几, 丶	丿, 一, 乚, 二, 丿, ㇠, 丶
繁	敏, 糸	丿, 一, 母, ⺙, 糸	丿, 一, ㇗, ㇆, ⺀, 一, 丿, 一, 乂, ㇛, 丶, 亅, 八
凡	几, 丶	几, 丶	丿, ㇠, 丶
烦	火, 页	火, 页	丿, 丶, 冫, 一, 丿, 冂, 人
反	⺁, 又	⺁, 又	丿, ㇒, ㇇, ㇏
返	辶, 反	辶, ⺁, 又	丶, ㇆, ㇝, 丿, ㇒, ㇇, ㇏
范	艹, 氾	艹, 氵, 乚, ㇆	艹, ⺀, ㇀, 乚, ㇆
贩	贝, 反	贝, ⺁, 又	冂, 人, 丿, ㇒, ㇇, ㇏
犯	犭, 㔾	犭, 乚, ㇆	㇁, ㇒, 乚, ㇆
饭	饣, 反	饣, ⺁, 又	⺈, 乚, 丿, ㇒, ㇇, ㇏
泛	氵, 乏	氵, ㇒, 王, 丶, 戈, ㇝	⺀, ㇀, ㇒, 一, 一, 丨, 一, 丶, 戈, ㇝
坊	土, 方	土, 方	一, 丨, 一, 一, 丶, 丿, ㇆
芳	艹, 方	艹, 方	艹, 一, 丶, 丿, ㇆
方	亠, No glyph available	方	一, 丶, 丿, ㇆
肪	月, 方	月, 方	冂, 二, 一, 丶, 丿, ㇆
房	户, 方	户, 方	丨, 匚, 丶, 一, 丶, 丿, ㇆
防	阝, 方	阝, 方	丨, ㇌, 一, 丶, 丿, ㇆
妨	女, 方	女, 方	㇛, 一, 丿, 一, 丶, 丿, ㇆
仿	亻, 方	亻, 方	㇒, 丨, 一, 丶, 丿, ㇆
访	讠, 方	讠, 方	㇊, 丶, 一, 丶, 丿, ㇆
纺	纟, 方	纟, 方	㇛, 一, 一, 丶, 丿, ㇆
放	方, ⺙	方, ⺙	一, 丶, 丿, ㇆, 丿, 一, 乂
菲	艹, 非	艹, 非	艹, 非
非	No glyph available	非	非
啡	口, 非	口, 非	口, 非
飞	㇠, No glyph available	飞	㇠, 冫
肥	月, 巴	月, 丨, No glyph availabl, 丨, 乚	冂, 二, 丨, 匚, 丨, 乚
匪	匚, 非	匚, 非	一, ㇗, 非
诽	讠, 非	讠, 非	㇊, 丶, 非
吠	口, 犬	口, 犬	口, 人, 一, 丶
肺	月, 巿	月, 十, 巾	冂, 二, 一, 丨, 冂, 丨
废	广, 发	广, ㇗, 丨, 丶, 又	厂, 丶, ㇗, 丨, 丶, ㇇, ㇏
沸	氵, 弗	氵, 弓, No glyph availabl	⺀, ㇀, 匚, ㇉, 丨
费	弗, 贝	弓, No glyph availabl, 贝	匚, ㇉, 丨, 冂, 人
芬	艹, 分	艹, 八, 刀	艹, 八, ㇆, 丿
酚	酉, 分	酉, 八, 刀	一, 丿, 乚, 口, 一, 八, ㇆, 丿
吩	口, 分	口, 八, 刀	口, 八, ㇆, 丿
氛	气, 分	气, 八, 刀	丿, 一, 一, ㇠, 八, ㇆, 丿
分	八, 刀	八, 刀	八, ㇆, 丿
纷	纟, 分	纟, 八, 刀	㇛, 一, 八, ㇆, 丿
坟	土, 文	土, 文	一, 丨, 一, 一, 丶, 乂
焚	林, 火	林, 火	林, 丿, 丶, 冫
汾	氵, 分	氵, 八, 刀	⺀, ㇀, 八, ㇆, 丿
粉	米, 分	米, 八, 刀	一, 丨, 八, 丷, 八, ㇆, 丿
奋	大, 田	大, 田	人, 一, 冂, 一, 丨, 一
份	亻, No glyph available	亻, 人, 刀	㇒, 丨, 人, ㇆, 丿
忿	分, 心	八, 刀, 心	八, ㇆, 丿, 𠁼, ㇃
愤	忄, 贲	忄, 十, 艹, 贝	丨, 八, 一, 丨, 艹, 冂, 人
粪	米, 共	米, 艹, 一, 八	一, 丨, 八, 丷, 艹, 一, 八
丰	三, 丨	一, 二, 丨	一, 二, 丨
封	圭, 寸	圭, 寸	圭, 𠂇, 亅, 丶
枫	木, 风	木, 风	一, 丨, 八, 丿, ㇠, 乂
蜂	虫, 夆	虫, 夂, 一, 二, 丨	口, 丨, 𠂉, ㇇, ㇏, ㇒, 一, 二, 丨
峰	山, 夆	山, 夂, 一, 二, 丨	丨, 凵, ㇇, ㇏, ㇒, 一, 二, 丨
锋	钅, 夆	钅, 夂, 一, 二, 丨	丿, 一, 乚, 二, ㇇, ㇏, ㇒, 一, 二, 丨
风	几, 乂	风	丿, ㇠, 乂
疯	疒, 风	疒, 风	一, 丶, 厂, 丶, 丿, ㇠, 乂
烽	火, 夆	火, 夂, 一, 二, 丨	丿, 丶, 冫, ㇇, ㇏, ㇒, 一, 二, 丨
逢	辶, 夆	辶, 夂, 一, 二, 丨	丶, ㇆, ㇝, ㇇, ㇏, ㇒, 一, 二, 丨
冯	冫, 马	冫, 马	丶, ㇀, ㇕, ㇉, 一
缝	纟, 逢	纟, 辶, 夂, 一, 二, 丨	㇛, 一, 丶, ㇆, ㇝, ㇇, ㇏, ㇒, 一, 二, 丨
讽	讠, 风	讠, 风	㇊, 丶, 丿, ㇠, 乂
奉	𡗗, No glyph available	一, 二, 丨, 八, 二, 丨	一, 二, 丨, 八, 二, 丨
凤	几, 又	几, 又	丿, ㇠, ㇇, ㇏
佛	亻, 弗	亻, 弓, No glyph availabl	㇒, 丨, 匚, ㇉, 丨
否	不, 口	一, 丿, 卜, 口	一, 丿, 丨, 丶, 口
夫	人, 二	人, 二	人, 二
敷	旉, ⺙	十, 用, 丶, 方, ⺙	一, 丨, 冂, 二, 丨, 丶, 一, 丶, 丿, ㇆, 丿, 一, 乂
肤	月, 夫	月, 人, 二	冂, 二, 人, 二
孵	卵, 孚	卵, 爫, 子	卵, 爫, ㇇, 亅, 一
扶	扌, 夫	扌, 人, 二	亅, 二, 人, 二
拂	扌, 弗	扌, 弓, No glyph availabl	亅, 二, 匚, ㇉, 丨
辐	车, 畐	车, 一, 口, 田	乚, 一, 一, 丨, 一, 口, 冂, 一, 丨, 一
幅	巾, 畐	巾, 一, 口, 田	冂, 丨, 一, 口, 冂, 一, 丨, 一
氟	气, 弗	气, 弓, No glyph availabl	丿, 一, 一, ㇠, 匚, ㇉, 丨
符	⺮, 付	⺮, 亻, 寸	⺮, ㇒, 丨, 𠂇, 亅, 丶
伏	亻, 犬	亻, 犬	㇒, 丨, 人, 一, 丶
俘	亻, 孚	亻, 爫, 子	㇒, 丨, 爫, ㇇, 亅, 一
服	月, 𠬝	月, 卩, 又	冂, 二, 丨, ㇆, ㇇, ㇏
浮	氵, 孚	氵, 爫, 子	⺀, ㇀, 爫, ㇇, 亅, 一
涪	氵, 咅	氵, 立, 口	⺀, ㇀, 一, 丶, 丷, 一, 口
福	礻, 畐	礻, 一, 口, 田	一, 一, 丨, 一, 丶, 戈, 丨, 丶, 一, 口, 冂, 一, 丨, 一
袱	衤, 伏	衤, 亻, 犬	一, 一, 丨, 一, 丶, 戈, 丨, 冫, ㇒, 丨, 人, 一, 丶
弗	弓, No glyph available	弓, No glyph availabl	匚, ㇉, 丨
甫	No glyph available, 丶	十, 用, 丶	一, 丨, 冂, 二, 丨, 丶
抚	扌, 无	扌, 无	亅, 二, 一, 𠂇, 乚
辅	车, 甫	车, 十, 用, 丶	乚, 一, 一, 丨, 一, 丨, 冂, 二, 丨, 丶
俯	亻, 府	亻, 广, 亻, 寸	㇒, 丨, 厂, 丶, ㇒, 丨, 𠂇, 亅, 丶
釜	父, 金	父, 金	八, 乂, 人, 一, 一, 丨, 一, 丷
斧	父, 斤	父, 斤	八, 乂, 丿, ㇒, 一, 丨
脯	月, 甫	月, 十, 用, 丶	冂, 二, 一, 丨, 冂, 二, 丨, 丶
腑	月, 府	月, 广, 亻, 寸	冂, 二, 厂, 丶, ㇒, 丨, 𠂇, 亅, 丶
府	广, 付	广, 亻, 寸	厂, 丶, ㇒, 丨, 𠂇, 亅, 丶
腐	府, 肉	广, 亻, 寸, 肉	厂, 丶, ㇒, 丨, 𠂇, 亅, 丶, 仌, 冂
赴	走, 卜	走, 卜	一, 丨, 一, 龰, 丨, 丶
副	畐, 刂	一, 口, 田, 刂	一, 口, 冂, 一, 丨, 一, 亅, 丨
覆	覀, 復	覀, 彳, 丿, 一, 日, 夂	覀, ㇒, 丨, 丿, 一, 口, 一, ㇇, ㇏, ㇒
赋	贝, 武	贝, 一, 弋, 止	冂, 人, 一, 弋, 丨, 一, 丨, 一
复	𠂉, No glyph available	丿, 一, 日, 夂	丿, 一, 口, 一, ㇇, ㇏, ㇒
傅	亻, 尃	亻, 十, 用, 丶, 寸	㇒, 丨, 一, 丨, 冂, 二, 丨, 丶, 𠂇, 亅, 丶
付	亻, 寸	亻, 寸	㇒, 丨, 𠂇, 亅, 丶
阜	𠂤, 十	阜	㠯, 丶, 一, 丨
父	八, 乂	父	八, 乂
腹	月, 复	月, 丿, 一, 日, 夂	冂, 二, 丿, 一, 口, 一, ㇇, ㇏, ㇒
负	⺈, 贝	⺈, 贝	⺈, 冂, 人
富	宀, 畐	宀, 一, 口, 田	冖, 丶, 一, 口, 冂, 一, 丨, 一
讣	讠, 卜	讠, 卜	㇊, 丶, 丨, 丶
附	阝, 付	阝, 亻, 寸	丨, ㇌, ㇒, 丨, 𠂇, 亅, 丶
妇	女, 彐	女, 彐	㇛, 一, 丿, ㇕, 二
缚	纟, 尃	纟, 十, 用, 丶, 寸	㇛, 一, 一, 丨, 冂, 二, 丨, 丶, 𠂇, 亅, 丶
咐	口, 付	口, 亻, 寸	口, ㇒, 丨, 𠂇, 亅, 丶
噶	口, 葛	口, 艹, 曰, 勹, 人, ㇗	口, 艹, 口, 一, ㇆, ㇒, 人, ㇗
嘎	口, 戛	口, 一, 自, 戈	口, 一, 口, 二, 丶, 戈
该	讠, 亥	讠, 亠, 丨, ㇙, 人	㇊, 丶, 一, 丶, 丨, ㇙, 人
改	己, ⺙	己, ⺙	匚, 乚, 丿, 一, 乂
概	木, 既	木, 丨, 彐, 乚, 丶, 旡	一, 丨, 八, 丨, ㇕, 二, 乚, 丶, 一, 丨, ㇜, 乚
钙	钅, 丐	钅, 一, 卜, ㇉	丿, 一, 乚, 二, 一, 丨, 丶, ㇉
盖	羊, 皿	羊, 皿	一, 二, 丨, 丷, 冂, 丨, 一
溉	氵, 既	氵, 丨, 彐, 乚, 丶, 旡	⺀, ㇀, 丨, ㇕, 二, 乚, 丶, 一, 丨, ㇜, 乚
干	一, 十	干	一, 一, 丨
甘	艹, 二	甘	艹, 二
杆	木, 干	木, 干	一, 丨, 八, 一, 一, 丨
柑	木, 甘	木, 甘	一, 丨, 八, 艹, 二
竿	⺮, 干	⺮, 干	⺮, 一, 一, 丨
肝	月, 干	月, 干	冂, 二, 一, 一, 丨
赶	走, 干	走, 干	一, 丨, 一, 龰, 一, 一, 丨
感	咸, 心	厂, 戈, 一, 口, 心	厂, 戈, 一, 口, 𠁼, ㇃
秆	禾, 干	禾, 干	㇒, 一, 丨, 八, 一, 一, 丨
敢	No glyph available, ⺙	No glyph availabl, 耳, ⺙	匚, 二, 丨, 二, 丿, 一, 乂
赣	章, No glyph available	立, 日, 十, 夂, 工, 贝	一, 丶, 丷, 一, 口, 一, 一, 丨, ㇇, ㇏, ㇒, 一, 丨, 一, 冂, 人
冈	冂, 乂	冂, 乂	冂, 乂
刚	冈, 刂	冂, 乂, 刂	冂, 乂, 亅, 丨
钢	钅, 冈	钅, 冂, 乂	丿, 一, 乚, 二, 冂, 乂
缸	缶, 工	缶, 工	一, 一, 丨, ㇒, 丨, 凵, 一, 丨, 一
肛	月, 工	月, 工	冂, 二, 一, 丨, 一
纲	纟, 冈	纟, 冂, 乂	㇛, 一, 冂, 乂
岗	山, 冈	山, 冂, 乂	丨, 凵, 冂, 乂
港	氵, 巷	氵, 艹, 一, 八, 巳	⺀, ㇀, 艹, 一, 八, 丨, 匚, 乚
杠	木, 工	木, 工	一, 丨, 八, 一, 丨, 一
篙	⺮, 高	⺮, 高	⺮, 一, 丶, 口, 冂, 口
皋	白, 夲	白, 大, 十	口, 一, ㇒, 人, 一, 一, 丨
高	No glyph available, 冋	高	一, 丶, 口, 冂, 口
膏	No glyph available, No glyph available	亠, 口, 冖, 口, 月	一, 丶, 口, 冖, 口, 冂, 二
羔	羊, 灬	羊, 灬	一, 二, 丨, 丷, 灬
糕	米, 羔	米, 羊, 灬	一, 丨, 八, 丷, 一, 二, 丨, 丷, 灬
搞	扌, 高	扌, 高	亅, 二, 一, 丶, 口, 冂, 口
镐	钅, 高	钅, 高	丿, 一, 乚, 二, 一, 丶, 口, 冂, 口
稿	禾, 高	禾, 高	㇒, 一, 丨, 八, 一, 丶, 口, 冂, 口
告	⺧, 口	⺧, 口	⺧, 口
哥	可	哥	哥
歌	哥, 欠	哥, 欠	哥, ⺈, 人
搁	扌, 阁	扌, 门, 夂, 口	亅, 二, 丶, 丨, ㇆, ㇇, ㇏, ㇒, 口
戈	㇂, 一, ㇒, 丶	戈	戈
鸽	合, 鸟	人, 一, 口, 鸟	人, 一, 口, ㇆, ㇉, 丶, 丶, 一
胳	月, 各	月, 夂, 口	冂, 二, ㇇, ㇏, ㇒, 口
疙	疒, 乞	疒, 丿, 一, ㇠	一, 丶, 厂, 丶, 丿, 一, ㇠
割	害, 刂	宀, 一, 二, 丨, 口, 刂	冖, 丶, 一, 二, 丨, 口, 亅, 丨
革	廿, No glyph available	革	卄, 一, 口, 丨, 一, 丨
葛	艹, 曷	艹, 曰, 勹, 人, ㇗	艹, 口, 一, ㇆, ㇒, 人, ㇗
格	木, 各	木, 夂, 口	一, 丨, 八, ㇇, ㇏, ㇒, 口
蛤	虫, 合	虫, 人, 一, 口	口, 丨, 𠂉, 人, 一, 口
阁	门, 各	门, 夂, 口	丶, 丨, ㇆, ㇇, ㇏, ㇒, 口
隔	阝, 鬲	阝, 鬲	丨, ㇌, 一, 口, 冂, 丷, 一, 丨
铬	钅, 各	钅, 夂, 口	丿, 一, 乚, 二, ㇇, ㇏, ㇒, 口
个	人, 丨	人, 丨	人, 丨
各	夂, 口	夂, 口	㇇, ㇏, ㇒, 口
给	纟, 合	纟, 人, 一, 口	㇛, 一, 人, 一, 口
根	木, 艮	木, 艮	一, 丨, 八, 丨, ㇕, 二, 乚, 冫
跟	⻊, 艮	⻊, 艮	口, 丨, 一, 丨, 一, 丨, ㇕, 二, 乚, 冫
耕	耒, 井	耒, No glyph availabl, 二	一, 二, 丨, 八, 丨, 二
更	一, No glyph available	一, 日, 丨, 乂	一, 口, 一, 丨, 乂
庚	广, No glyph available	广, ⺺, 八	厂, 丶, 匚, 一, 丨, 八
羹	羔, 美	羊, 灬, 羊, 大	一, 二, 丨, 丷, 灬, 一, 二, 丨, 丷, 人, 一
埂	土, 更	土, 一, 日, 丨, 乂	一, 丨, 一, 一, 口, 一, 丨, 乂
耿	耳, 火	耳, 火	二, 丨, 二, 丿, 丶, 冫
梗	木, 更	木, 一, 日, 丨, 乂	一, 丨, 八, 一, 口, 一, 丨, 乂
工	一, 丄	工	一, 丨, 一
攻	工, ⺙	工, ⺙	一, 丨, 一, 丿, 一, 乂
功	工, 力	工, 力	一, 丨, 一, ㇆, 丿
恭	共, 㣺	艹, 一, 八, 丨, ㇒, No glyph availabl	艹, 一, 八, 丨, ㇒, ㇏
龚	龙, 共	龙, 艹, 一, 八	𠂇, 丶, 乚, ㇒, 艹, 一, 八
供	亻, 共	亻, 艹, 一, 八	㇒, 丨, 艹, 一, 八
躬	身, 弓	身, 弓	𠂎, 丶, 二, 丿, 匚, ㇉
公	八, 厶	八, 厶	八, ㇛, 丶
宫	宀, 吕	宀, 吕	冖, 丶, 吕
弓	No glyph available, ㇉	弓	匚, ㇉
巩	工, 凡	工, 几, 丶	一, 丨, 一, 丿, ㇠, 丶
汞	工, 水	工, 水	一, 丨, 一, 亅, ㇇, 冫
拱	扌, 共	扌, 艹, 一, 八	亅, 二, 艹, 一, 八
贡	工, 贝	工, 贝	一, 丨, 一, 冂, 人
共	龷, 八	艹, 一, 八	艹, 一, 八
钩	钅, 勾	钅, 勹, 厶	丿, 一, 乚, 二, ㇆, ㇒, ㇛, 丶
勾	勹, 厶	勹, 厶	㇆, ㇒, ㇛, 丶
沟	氵, 勾	氵, 勹, 厶	⺀, ㇀, ㇆, ㇒, ㇛, 丶
苟	艹, 句	艹, 勹, 口	艹, ㇆, ㇒, 口
狗	犭, 句	犭, 勹, 口	㇁, ㇒, ㇆, ㇒, 口
垢	土, 后	土, ⺁, 一, 口	一, 丨, 一, 丿, ㇒, 一, 口
构	木, 勾	木, 勹, 厶	一, 丨, 八, ㇆, ㇒, ㇛, 丶
购	贝, 勾	贝, 勹, 厶	冂, 人, ㇆, ㇒, ㇛, 丶
够	句, 多	勹, 口, 多	㇆, ㇒, 口, 多
辜	古, 辛	十, 口, 辛	一, 丨, 口, 一, 丶, 丷, 一, 一, 丨
菇	艹, 姑	艹, 女, 十, 口	艹, ㇛, 一, 丿, 一, 丨, 口
咕	口, 古	口, 十, 口	口, 一, 丨, 口
箍	⺮, 㧜	⺮, 扌, 匚, 巾	⺮, 亅, 二, 一, ㇗, 冂, 丨
估	亻, 古	亻, 十, 口	㇒, 丨, 一, 丨, 口
沽	氵, 古	氵, 十, 口	⺀, ㇀, 一, 丨, 口
孤	子, 瓜	子, 瓜	㇇, 亅, 一, 丿, ㇒, ㇏, ㇛, 丶
姑	女, 古	女, 十, 口	㇛, 一, 丿, 一, 丨, 口
鼓	壴, 支	鼓	一, 丨, 一, 口, 丷, 一, 一, 丨, ㇇, ㇏
古	十, 口	十, 口	一, 丨, 口
蛊	虫, 皿	虫, 皿	口, 丨, 𠂉, 冂, 丨, 一
骨	冎, 月	骨	冂, ㇆, 冂, 冂, 二
谷	八, No glyph available	谷	八, 人, 口
股	月, 殳	月, 殳	冂, 二, 丿, ㇠, ㇇, ㇏
故	古, ⺙	十, 口, ⺙	一, 丨, 口, 丿, 一, 乂
顾	厄, 页	厂, 乚, ㇆, 页	厂, 乚, ㇆, 一, 丿, 冂, 人
固	囗, 古	囗, 十, 口	冂, 一, 一, 丨, 口
雇	户, 隹	户, 隹	丨, 匚, 丶, ㇒, 丨, 一, 二, 丨, 一, 丶
刮	舌, 刂	舌, 刂	㇒, 一, 丨, 口, 亅, 丨
瓜	No glyph available, 厶	瓜	丿, ㇒, ㇏, ㇛, 丶
剐	呙, 刂	口, 人, 冂, 刂	口, 人, 冂, 亅, 丨
寡	宀, No glyph available	宀, 一, 丿, 月, 一, 八, 刀	冖, 丶, 一, 丿, 冂, 二, 一, 八, ㇆, 丿
挂	扌, 圭	扌, 圭	亅, 二, 圭
褂	衤, 卦	衤, 圭, 卜	一, 一, 丨, 一, 丶, 戈, 丨, 冫, 圭, 丨, 丶
乖	千, 北	㇒, 十, 北	㇒, 一, 丨, 北
拐	扌, 另	扌, 口, 力	亅, 二, 口, ㇆, 丿
怪	忄, 圣	忄, 又, 土	丨, 八, ㇇, ㇏, 一, 丨, 一
棺	木, 官	木, 宀, 㠯	一, 丨, 八, 冖, 丶, 㠯
关	丷, 天	丷, 一, 大	丷, 一, 人, 一
官	宀, 㠯	宀, 㠯	冖, 丶, 㠯
冠	冖, 㝴	冖, 二, 儿, 寸	冖, 二, 丿, 乚, 𠂇, 亅, 丶
观	又, 见	又, 见	㇇, ㇏, 冂, 丿, 乚
管	⺮, 官	⺮, 宀, 㠯	⺮, 冖, 丶, 㠯
馆	饣, 官	饣, 宀, 㠯	⺈, 乚, 冖, 丶, 㠯
罐	缶, 雚	缶, 艹, 吅, 隹	一, 一, 丨, ㇒, 丨, 凵, 艹, 吅, ㇒, 丨, 一, 二, 丨, 一, 丶
惯	忄, 贯	忄, 囗, 十, 贝	丨, 八, 冂, 一, 一, 丨, 冂, 人
灌	氵, 雚	氵, 艹, 吅, 隹	⺀, ㇀, 艹, 吅, ㇒, 丨, 一, 二, 丨, 一, 丶
贯	毌, 贝	囗, 十, 贝	冂, 一, 一, 丨, 冂, 人
光	⺌, 兀	⺌, 一, 儿	丨, 丷, 一, 丿, 乚
广	厂, 丶	广	厂, 丶
逛	辶, 狂	辶, 犭, 王	丶, ㇆, ㇝, ㇁, ㇒, 一, 一, 丨, 一
瑰	王, 鬼	王, 鬼	一, 一, 丨, 一, 冂, 二, 丨, 丶, 乚, ㇛, 丶
规	夫, 见	人, 二, 见	人, 二, 冂, 丿, 乚
圭	土	圭	圭
硅	石, 圭	石, 圭	一, 丿, 口, 圭
归	No glyph available, 彐	No glyph availabl, 彐	丨, 丨, ㇕, 二
龟	⺈, 电	龟	⺈, 口, 一, 丨, 乚
闺	门, 圭	门, 圭	丶, 丨, ㇆, 圭
轨	车, 九	车, 丿, ㇈	乚, 一, 一, 丨, 丿, ㇈
鬼	No glyph available, No glyph available	鬼	冂, 二, 丨, 丶, 乚, ㇛, 丶
诡	讠, 危	讠, ⺈, 厂, 乚, ㇆	㇊, 丶, ⺈, 厂, 乚, ㇆
癸	癶, 天	癶, 一, 大	癶, 一, 人, 一
桂	木, 圭	木, 圭	一, 丨, 八, 圭
柜	木, 巨	木, 匚, No glyph availabl	一, 丨, 八, 一, ㇗, 匚
跪	⻊, 危	⻊, ⺈, 厂, 乚, ㇆	口, 丨, 一, 丨, 一, ⺈, 厂, 乚, ㇆
贵	𠀐, 贝	口, 丨, 一, 贝	口, 丨, 一, 冂, 人
刽	会, 刂	人, 二, 厶, 刂	人, 二, ㇛, 丶, 亅, 丨
辊	车, 昆	车, 日, 比	乚, 一, 一, 丨, 口, 一, 比
滚	氵, 衮	氵, 衣, 八, 厶	⺀, ㇀, 一, 丶, ㇒, ㇗, 冫, 八, ㇛, 丶
棍	木, 昆	木, 日, 比	一, 丨, 八, 口, 一, 比
锅	钅, 呙	钅, 口, 人, 冂	丿, 一, 乚, 二, 口, 人, 冂
郭	享, 阝	亠, 口, 子, 阝	一, 丶, 口, ㇇, 亅, 一, 丨, ㇌
国	囗, 玉	囗, 玉	冂, 一, 一, 一, 丨, 一, 丶
果	田, 木	田, 木	冂, 一, 丨, 一, 一, 丨, 八
裹	衣, 果	衣, 田, 木	一, 丶, ㇒, ㇗, 冫, 冂, 一, 丨, 一, 一, 丨, 八
过	辶, 寸	辶, 寸	丶, ㇆, ㇝, 𠂇, 亅, 丶
哈	口, 合	口, 人, 一, 口	口, 人, 一, 口
骸	骨, 亥	骨, 亠, 丨, ㇙, 人	冂, ㇆, 冂, 冂, 二, 一, 丶, 丨, ㇙, 人
孩	子, 亥	子, 亠, 丨, ㇙, 人	㇇, 亅, 一, 一, 丶, 丨, ㇙, 人
海	氵, 每	氵, 丿, 一, 母	⺀, ㇀, 丿, 一, ㇗, ㇆, ⺀, 一
氦	气, 亥	气, 亠, 丨, ㇙, 人	丿, 一, 一, ㇠, 一, 丶, 丨, ㇙, 人
亥	No glyph available, 人	亠, 丨, ㇙, 人	一, 丶, 丨, ㇙, 人
害	宀, No glyph available	宀, 一, 二, 丨, 口	冖, 丶, 一, 二, 丨, 口
骇	马, 亥	马, 亠, 丨, ㇙, 人	㇕, ㇉, 一, 一, 丶, 丨, ㇙, 人
酣	酉, 甘	酉, 甘	一, 丿, 乚, 口, 一, 艹, 二
憨	敢, 心	No glyph availabl, 耳, ⺙, 心	匚, 二, 丨, 二, 丿, 一, 乂, 𠁼, ㇃
邯	甘, 阝	甘, 阝	艹, 二, 丨, ㇌
韩	龺, 韦	十, 日, 十, 韦	一, 丨, 口, 一, 一, 丨, 一, 二, ㇆, 丨
含	今, 口	人, 丶, ㇇, 口	人, 丶, ㇇, 口
涵	氵, No glyph available	氵, ㇇, 亅, 冫, No glyph availabl, 凵	⺀, ㇀, ㇇, 亅, 丶, ㇀, 冫, 凵
寒	宀, No glyph available	宀, No glyph availabl, 二, 一, 八, ⺀	冖, 丶, 丨, 二, 一, 八, ⺀
函	凵, No glyph available	凵, ㇇, 亅, 冫, No glyph availabl	凵, ㇇, 亅, 丶, ㇀, 冫
喊	口, 咸	口, 厂, 戈, 一, 口	口, 厂, 戈, 一, 口
罕	⺳, 干	⺳, 干	冖, 八, 一, 一, 丨
翰	龺, No glyph available	十, 日, 十, 人, 羽	一, 丨, 口, 一, 一, 丨, 人, 羽
撼	扌, 感	扌, 厂, 戈, 一, 口, 心	亅, 二, 厂, 戈, 一, 口, 𠁼, ㇃
捍	扌, 旱	扌, 日, 干	亅, 二, 口, 一, 一, 一, 丨
旱	日, 干	日, 干	口, 一, 一, 一, 丨
憾	忄, 感	忄, 厂, 戈, 一, 口, 心	丨, 八, 厂, 戈, 一, 口, 𠁼, ㇃
悍	忄, 旱	忄, 日, 干	丨, 八, 口, 一, 一, 一, 丨
焊	火, 旱	火, 日, 干	丿, 丶, 冫, 口, 一, 一, 一, 丨
汗	氵, 干	氵, 干	⺀, ㇀, 一, 一, 丨
汉	氵, 又	氵, 又	⺀, ㇀, ㇇, ㇏
夯	大, 力	大, 力	人, 一, ㇆, 丿
杭	木, 亢	木, 亠, 几	一, 丨, 八, 一, 丶, 丿, ㇠
航	舟, 亢	舟, 亠, 几	冂, 丶, ⺀, 一, 一, 丶, 丿, ㇠
壕	土, 豪	土, 亠, 口, 冖, 豕	一, 丨, 一, 一, 丶, 口, 冖, 一, ㇆, ㇒, ㇒, 冫
嚎	口, 豪	口, 亠, 口, 冖, 豕	口, 一, 丶, 口, 冖, 一, ㇆, ㇒, ㇒, 冫
豪	No glyph available, 豕	亠, 口, 冖, 豕	一, 丶, 口, 冖, 一, ㇆, ㇒, ㇒, 冫
毫	No glyph available, 毛	亠, 口, 冖, 毛	一, 丶, 口, 冖, ㇒, 二, 乚
郝	赤, 阝	赤, 阝	一, 丨, 一, 丨, 亅, 八, 丨, ㇌
好	女, 子	女, 子	㇛, 一, 丿, ㇇, 亅, 一
耗	耒, 毛	耒, 毛	一, 二, 丨, 八, ㇒, 二, 乚
号	口, 丂	口, 一, ㇉	口, 一, ㇉
浩	氵, 告	氵, ⺧, 口	⺀, ㇀, ⺧, 口
呵	口, 可	口, 一, 亅, 口	口, 一, 亅, 口
喝	口, 曷	口, 曰, 勹, 人, ㇗	口, 口, 一, ㇆, ㇒, 人, ㇗
荷	艹, 何	艹, 亻, 一, 亅, 口	艹, ㇒, 丨, 一, 亅, 口
菏	艹, 河	艹, 氵, 一, 亅, 口	艹, ⺀, ㇀, 一, 亅, 口
核	木, 亥	木, 亠, 丨, ㇙, 人	一, 丨, 八, 一, 丶, 丨, ㇙, 人
禾	㇒, 木	禾	㇒, 一, 丨, 八
和	禾, 口	禾, 口	㇒, 一, 丨, 八, 口
何	亻, 可	亻, 一, 亅, 口	㇒, 丨, 一, 亅, 口
合	亼, 口	人, 一, 口	人, 一, 口
盒	合, 皿	人, 一, 口, 皿	人, 一, 口, 冂, 丨, 一
貉	豸, 各	豸, 夂, 口	爫, ㇁, ㇒, ㇇, ㇏, ㇒, 口
阂	门, 亥	门, 亠, 丨, ㇙, 人	丶, 丨, ㇆, 一, 丶, 丨, ㇙, 人
河	氵, 可	氵, 一, 亅, 口	⺀, ㇀, 一, 亅, 口
涸	氵, 固	氵, 囗, 十, 口	⺀, ㇀, 冂, 一, 一, 丨, 口
赫	赤	赫	赫
褐	衤, 曷	衤, 曰, 勹, 人, ㇗	一, 一, 丨, 一, 丶, 戈, 丨, 冫, 口, 一, ㇆, ㇒, 人, ㇗
鹤	隺, 鸟	巾, 隹, 鸟	冂, 丨, ㇒, 丨, 一, 二, 丨, 一, 丶, ㇆, ㇉, 丶, 丶, 一
贺	加, 贝	力, 口, 贝	㇆, 丿, 口, 冂, 人
嘿	口, 黑	口, 黑	口, 口, 丨, 丷, 一, 丨, 一, 灬
黑	No glyph available, 灬	黑	口, 丨, 丷, 一, 丨, 一, 灬
痕	疒, 艮	疒, 艮	一, 丶, 厂, 丶, 丨, ㇕, 二, 乚, 冫
很	彳, 艮	彳, 艮	㇒, 丨, 丨, ㇕, 二, 乚, 冫
狠	犭, 艮	犭, 艮	㇁, ㇒, 丨, ㇕, 二, 乚, 冫
恨	忄, 艮	忄, 艮	丨, 八, 丨, ㇕, 二, 乚, 冫
哼	口, 亨	口, 亠, 口, ㇇, 亅	口, 一, 丶, 口, ㇇, 亅
亨	No glyph available, 了	亠, 口, ㇇, 亅	一, 丶, 口, ㇇, 亅
横	木, 黄	木, 艹, 一, 二, 丨, 凵, 八	一, 丨, 八, 艹, 一, 二, 丨, 凵, 八
衡	行, No glyph available	行, ⺈, 田, 大	㇒, 丨, 二, 亅, ⺈, 冂, 一, 丨, 一, 人, 一
恒	忄, 亘	忄, 一, 日, 一	丨, 八, 一, 口, 一, 一
轰	车, 双	车, 双	乚, 一, 一, 丨, 双
哄	口, 共	口, 艹, 一, 八	口, 艹, 一, 八
烘	火, 共	火, 艹, 一, 八	丿, 丶, 冫, 艹, 一, 八
虹	虫, 工	虫, 工	口, 丨, 𠂉, 一, 丨, 一
鸿	氵, No glyph available	氵, 工, 鸟	⺀, ㇀, 一, 丨, 一, ㇆, ㇉, 丶, 丶, 一
洪	氵, 共	氵, 艹, 一, 八	⺀, ㇀, 艹, 一, 八
宏	宀, 厷	宀, 𠂇, 厶	冖, 丶, 𠂇, ㇛, 丶
弘	弓, 厶	弓, 厶	匚, ㇉, ㇛, 丶
红	纟, 工	纟, 工	㇛, 一, 一, 丨, 一
喉	口, 侯	口, 亻, No glyph availabl, 矢	口, ㇒, 丨, 匚, 丿, 一, 人, 一
侯	亻, No glyph available	亻, No glyph availabl, 矢	㇒, 丨, 匚, 丿, 一, 人, 一
猴	犭, 侯	犭, 亻, No glyph availabl, 矢	㇁, ㇒, ㇒, 丨, 匚, 丿, 一, 人, 一
吼	口, 孔	口, 子, 乚	口, ㇇, 亅, 一, 乚
厚	No glyph available, 子	厂, 日, 子	厂, 口, 一, ㇇, 亅, 一
候	No glyph available, No glyph available	亻, 丨, No glyph availabl, 矢	㇒, 丨, 丨, 匚, 丿, 一, 人, 一
后	⺁, 𠮛	⺁, 一, 口	丿, ㇒, 一, 口
呼	口, 乎	口, ㇒, 𠂇, 丷	口, ㇒, 𠂇, 丷
乎	㇒, No glyph available	㇒, 𠂇, 丷	㇒, 𠂇, 丷
忽	勿, 心	勹, No glyph availabl, 心	㇆, ㇒, ㇒, 𠁼, ㇃
瑚	王, 胡	王, 十, 口, 月	一, 一, 丨, 一, 一, 丨, 口, 冂, 二
壶	士, No glyph available	士, 冖, No glyph availabl, 丷, 一	一, 丨, 一, 冖, 丨, 丷, 一
葫	艹, 胡	艹, 十, 口, 月	艹, 一, 丨, 口, 冂, 二
胡	古, 月	十, 口, 月	一, 丨, 口, 冂, 二
蝴	虫, 胡	虫, 十, 口, 月	口, 丨, 𠂉, 一, 丨, 口, 冂, 二
狐	犭, 瓜	犭, 瓜	㇁, ㇒, 丿, ㇒, ㇏, ㇛, 丶
糊	米, 胡	米, 十, 口, 月	一, 丨, 八, 丷, 一, 丨, 口, 冂, 二
湖	氵, 胡	氵, 十, 口, 月	⺀, ㇀, 一, 丨, 口, 冂, 二
弧	弓, 瓜	弓, 瓜	匚, ㇉, 丿, ㇒, ㇏, ㇛, 丶
虎	虍, 几	虍, 几	丨, 一, 冖, 乚, 一, 丿, ㇠
唬	口, 虎	口, 虍, 几	口, 丨, 一, 冖, 乚, 一, 丿, ㇠
护	扌, 户	扌, 户	亅, 二, 丨, 匚, 丶
互	一, 彑	一, 彑	一, ㇗, ㇕, 一
沪	氵, 户	氵, 户	⺀, ㇀, 丨, 匚, 丶
户	尸, 丶	户	丨, 匚, 丶
花	艹, 化	艹, 亻, 匕	艹, ㇒, 丨, 乚, ㇒
哗	口, 华	口, 亻, 匕, 十	口, ㇒, 丨, 乚, ㇒, 一, 丨
华	化, 十	亻, 匕, 十	㇒, 丨, 乚, ㇒, 一, 丨
猾	犭, 骨	犭, 骨	㇁, ㇒, 冂, ㇆, 冂, 冂, 二
滑	氵, 骨	氵, 骨	⺀, ㇀, 冂, ㇆, 冂, 冂, 二
画	一, No glyph available	一, 田, 凵	一, 冂, 一, 丨, 一, 凵
划	戈, 刂	戈, 刂	戈, 亅, 丨
化	亻, 匕	亻, 匕	㇒, 丨, 乚, ㇒
话	讠, 舌	讠, 舌	㇊, 丶, ㇒, 一, 丨, 口
槐	木, 鬼	木, 鬼	一, 丨, 八, 冂, 二, 丨, 丶, 乚, ㇛, 丶
徊	彳, 回	彳, 回	㇒, 丨, 回
怀	忄, 不	忄, 一, 丿, 卜	丨, 八, 一, 丿, 丨, 丶
淮	氵, 隹	氵, 隹	⺀, ㇀, ㇒, 丨, 一, 二, 丨, 一, 丶
坏	土, 不	土, 一, 丿, 卜	一, 丨, 一, 一, 丿, 丨, 丶
欢	又, 欠	又, 欠	㇇, ㇏, ⺈, 人
环	王, 不	王, 一, 丿, 卜	一, 一, 丨, 一, 一, 丿, 丨, 丶
桓	木, 亘	木, 一, 日, 一	一, 丨, 八, 一, 口, 一, 一
还	辶, 不	辶, 一, 丿, 卜	丶, ㇆, ㇝, 一, 丿, 丨, 丶
缓	纟, 爰	纟, 爫, 干, 又	㇛, 一, 爫, 一, 一, 丨, ㇇, ㇏
换	扌, 奂	扌, ⺈, 大, 冂	亅, 二, ⺈, 人, 一, 冂
患	串, 心	串, 心	串, 𠁼, ㇃
唤	口, 奂	口, ⺈, 大, 冂	口, ⺈, 人, 一, 冂
痪	疒, 奂	疒, ⺈, 大, 冂	一, 丶, 厂, 丶, ⺈, 人, 一, 冂
豢	龹, 豕	二, 丨, 丷, 八, 豕	二, 丨, 丷, 八, 一, ㇆, ㇒, ㇒, 冫
焕	火, 奂	火, ⺈, 大, 冂	丿, 丶, 冫, ⺈, 人, 一, 冂
涣	氵, 奂	氵, ⺈, 大, 冂	⺀, ㇀, ⺈, 人, 一, 冂
宦	宀, 臣	宀, 臣	冖, 丶, 一, ㇗, 丨, 匚
幻	幺, ㇆	幺, ㇆	㇛, 丶, ㇆
荒	芒, No glyph available	艹, 匸, 丶, 儿, 丨	艹, 匸, 丶, 丿, 乚, 丨
慌	忄, 荒	忄, 艹, 匸, 丶, 儿, 丨	丨, 八, 艹, 匸, 丶, 丿, 乚, 丨
黄	龷, No glyph available	艹, 一, 二, 丨, 凵, 八	艹, 一, 二, 丨, 凵, 八
磺	石, 黄	石, 艹, 一, 二, 丨, 凵, 八	一, 丿, 口, 艹, 一, 二, 丨, 凵, 八
蝗	虫, 皇	虫, 白, 王	口, 丨, 𠂉, 口, 一, ㇒, 一, 一, 丨, 一
簧	⺮, 黄	⺮, 艹, 一, 二, 丨, 凵, 八	⺮, 艹, 一, 二, 丨, 凵, 八
皇	白, 王	白, 王	口, 一, ㇒, 一, 一, 丨, 一
凰	几, 皇	几, 白, 王	丿, ㇠, 口, 一, ㇒, 一, 一, 丨, 一
惶	忄, 皇	忄, 白, 王	丨, 八, 口, 一, ㇒, 一, 一, 丨, 一
煌	火, 皇	火, 白, 王	丿, 丶, 冫, 口, 一, ㇒, 一, 一, 丨, 一
晃	日, 光	日, ⺌, 一, 儿	口, 一, 丨, 丷, 一, 丿, 乚
幌	巾, 晃	巾, 日, ⺌, 一, 儿	冂, 丨, 口, 一, 丨, 丷, 一, 丿, 乚
恍	忄, 光	忄, ⺌, 一, 儿	丨, 八, 丨, 丷, 一, 丿, 乚
谎	讠, 荒	讠, 艹, 匸, 丶, 儿, 丨	㇊, 丶, 艹, 匸, 丶, 丿, 乚, 丨
灰	𠂇, 火	𠂇, 火	𠂇, 丿, 丶, 冫
挥	扌, 军	扌, 冖, 车	亅, 二, 冖, 乚, 一, 一, 丨
辉	光, 军	⺌, 一, 儿, 冖, 车	丨, 丷, 一, 丿, 乚, 冖, 乚, 一, 一, 丨
徽	彳, No glyph available	彳, 山, ⺙, ㇒, 糸	㇒, 丨, 丨, 凵, 丿, 一, 乂, ㇒, ㇛, 丶, 亅, 八
恢	忄, 灰	忄, 𠂇, 火	丨, 八, 𠂇, 丿, 丶, 冫
蛔	虫, 回	虫, 回	口, 丨, 𠂉, 回
回	囗	回	回
毁	No glyph available, 殳	臼, 工, 殳	臼, 一, 丨, 一, 丿, ㇠, ㇇, ㇏
悔	忄, 每	忄, 丿, 一, 母	丨, 八, 丿, 一, ㇗, ㇆, ⺀, 一
慧	彗, 心	No glyph availabl, 彐, 心	丰, ㇕, 二, 𠁼, ㇃
卉	十, 艹	十, 艹	一, 丨, 艹
惠	No glyph available, 心	十, 日, 丨, No glyph availabl, 心	一, 丨, 口, 一, 丨, 𠂉, 𠁼, ㇃
晦	日, 每	日, 丿, 一, 母	口, 一, 丿, 一, ㇗, ㇆, ⺀, 一
贿	贝, 有	贝, 𠂇, 月	冂, 人, 𠂇, 冂, 二
秽	禾, 岁	禾, 山, 夕	㇒, 一, 丨, 八, 丨, 凵, 夕
会	人, 云	人, 二, 厶	人, 二, ㇛, 丶
烩	火, 会	火, 人, 二, 厶	丿, 丶, 冫, 人, 二, ㇛, 丶
汇	氵, 匚	氵, 匚	⺀, ㇀, 一, ㇗
讳	讠, 韦	讠, 韦	㇊, 丶, 一, 二, ㇆, 丨
诲	讠, 每	讠, 丿, 一, 母	㇊, 丶, 丿, 一, ㇗, ㇆, ⺀, 一
绘	纟, 会	纟, 人, 二, 厶	㇛, 一, 人, 二, ㇛, 丶
荤	艹, 军	艹, 冖, 车	艹, 冖, 乚, 一, 一, 丨
昏	氏, 日	氏, 日	㇒, ㇗, ㇂, 一, 口, 一
婚	女, 昏	女, 氏, 日	㇛, 一, 丿, ㇒, ㇗, ㇂, 一, 口, 一
魂	云, 鬼	二, 厶, 鬼	二, ㇛, 丶, 冂, 二, 丨, 丶, 乚, ㇛, 丶
浑	氵, 军	氵, 冖, 车	⺀, ㇀, 冖, 乚, 一, 一, 丨
混	氵, 昆	氵, 日, 比	⺀, ㇀, 口, 一, 比
豁	害, 谷	宀, 一, 二, 丨, 口, 谷	冖, 丶, 一, 二, 丨, 口, 八, 人, 口
活	氵, 舌	氵, 舌	⺀, ㇀, ㇒, 一, 丨, 口
伙	亻, 火	亻, 火	㇒, 丨, 丿, 丶, 冫
火	No glyph available, No glyph available	火	丿, 丶, 冫
获	艹, 犾	艹, 犭, 犬	艹, ㇁, ㇒, 人, 一, 丶
或	戓, 一	戈, 口, 一	戈, 口, 一
惑	或, 心	戈, 口, 一, 心	戈, 口, 一, 𠁼, ㇃
霍	雨, 隹	雨, 隹	一, 冂, 丨, 丶, ㇀, 冫, ㇒, 丨, 一, 二, 丨, 一, 丶
货	化, 贝	亻, 匕, 贝	㇒, 丨, 乚, ㇒, 冂, 人
祸	礻, 呙	礻, 口, 人, 冂	一, 一, 丨, 一, 丶, 戈, 丨, 丶, 口, 人, 冂
击	No glyph available, 山	二, 丨, 山	二, 丨, 丨, 凵
圾	土, 及	土, ㇎, 丿, ㇏	一, 丨, 一, ㇎, 丿, ㇏
基	其, 土	甘, 一, 八, 土	艹, 二, 一, 八, 一, 丨, 一
机	木, 几	木, 几	一, 丨, 八, 丿, ㇠
畸	田, 奇	田, 大, 一, 亅, 口	冂, 一, 丨, 一, 人, 一, 一, 亅, 口
稽	禾, No glyph available	禾, 尢, 丶, 匕, 日	㇒, 一, 丨, 八, 𠂇, 乚, 丶, 乚, ㇒, 口, 一
积	禾, 只	禾, 口, 八	㇒, 一, 丨, 八, 口, 八
箕	⺮, 其	⺮, 甘, 一, 八	⺮, 艹, 二, 一, 八
肌	月, 几	月, 几	冂, 二, 丿, ㇠
饥	饣, 几	饣, 几	⺈, 乚, 丿, ㇠
迹	辶, 亦	辶, 亠, 丨, 亅, 八	丶, ㇆, ㇝, 一, 丶, 丨, 亅, 八
激	氵, 敫	氵, 白, 方, ⺙	⺀, ㇀, 口, 一, ㇒, 一, 丶, 丿, ㇆, 丿, 一, 乂
讥	讠, 几	讠, 几	㇊, 丶, 丿, ㇠
鸡	又, 鸟	又, 鸟	㇇, ㇏, ㇆, ㇉, 丶, 丶, 一
姬	女, 𦣞	女, 匚, No glyph availabl, 口	㇛, 一, 丿, 一, ㇗, 丨, 口
绩	纟, 责	纟, 龶, 贝	㇛, 一, 龶, 冂, 人
缉	纟, 咠	纟, 口, 耳	㇛, 一, 口, 二, 丨, 二
吉	士, 口	士, 口	一, 丨, 一, 口
极	木, 及	木, ㇎, 丿, ㇏	一, 丨, 八, ㇎, 丿, ㇏
棘	朿	棘	棘
辑	车, 咠	车, 口, 耳	乚, 一, 一, 丨, 口, 二, 丨, 二
籍	⺮, 耤	⺮, 耒, 艹, 一, 日	⺮, 一, 二, 丨, 八, 艹, 一, 口, 一
集	隹, 木	隹, 木	㇒, 丨, 一, 二, 丨, 一, 丶, 一, 丨, 八
及	乃, ㇏	㇎, 丿, ㇏	㇎, 丿, ㇏
急	刍, 心	⺈, 彐, 心	⺈, ㇕, 二, 𠁼, ㇃
疾	疒, 矢	疒, 矢	一, 丶, 厂, 丶, 丿, 一, 人, 一
汲	氵, 及	氵, ㇎, 丿, ㇏	⺀, ㇀, ㇎, 丿, ㇏
即	No glyph available, 卩	丨, 彐, 乚, 丶, 卩	丨, ㇕, 二, 乚, 丶, 丨, ㇆
嫉	女, 疾	女, 疒, 矢	㇛, 一, 丿, 一, 丶, 厂, 丶, 丿, 一, 人, 一
级	纟, 及	纟, ㇎, 丿, ㇏	㇛, 一, ㇎, 丿, ㇏
挤	扌, 齐	扌, 齐	亅, 二, 一, 丶, 乂, 丨
几	丿, ㇠	几	丿, ㇠
脊	No glyph available, 月	人, 冫, No glyph availabl, 月	人, 丶, ㇀, 冫, 冂, 二
己	No glyph available, 乚	己	匚, 乚
蓟	艹, No glyph available	艹, 鱼, 刂	艹, ⺈, 冂, 一, 丨, 一, 一, 亅, 丨
技	扌, 支	扌, 支	亅, 二, 一, 丨, ㇇, ㇏
冀	北, 異	北, 田, 艹, 一, 八	北, 冂, 一, 丨, 一, 艹, 一, 八
季	禾, 子	禾, 子	㇒, 一, 丨, 八, ㇇, 亅, 一
伎	亻, 支	亻, 支	㇒, 丨, 一, 丨, ㇇, ㇏
祭	No glyph available, 示	月, 卩, 示	冂, 二, 丨, ㇆, 二, 亅, 八
剂	齐, 刂	齐, 刂	一, 丶, 乂, 丨, 亅, 丨
悸	忄, 季	忄, 禾, 子	丨, 八, ㇒, 一, 丨, 八, ㇇, 亅, 一
济	氵, 齐	氵, 齐	⺀, ㇀, 一, 丶, 乂, 丨
寄	宀, 奇	宀, 大, 一, 亅, 口	冖, 丶, 人, 一, 一, 亅, 口
寂	宀, 叔	宀, ⺊, 一, 小, 又	冖, 丶, 丨, 一, 一, 亅, 八, ㇇, ㇏
计	讠, 十	讠, 十	㇊, 丶, 一, 丨
记	讠, 己	讠, 己	㇊, 丶, 匚, 乚
既	No glyph available, 旡	丨, 彐, 乚, 丶, 旡	丨, ㇕, 二, 乚, 丶, 一, 丨, ㇜, 乚
忌	己, 心	己, 心	匚, 乚, 𠁼, ㇃
际	阝, 示	阝, 示	丨, ㇌, 二, 亅, 八
妓	女, 支	女, 支	㇛, 一, 丿, 一, 丨, ㇇, ㇏
继	纟, No glyph available	纟, ㇗, 米	㇛, 一, ㇗, 一, 丨, 八, 丷
纪	纟, 己	纟, 己	㇛, 一, 匚, 乚
嘉	士, No glyph available	士, 口, 丷, 一, 力, 口	一, 丨, 一, 口, 丷, 一, ㇆, 丿, 口
枷	木, 加	木, 力, 口	一, 丨, 八, ㇆, 丿, 口
夹	夫, 丷	人, 二, 丷	人, 二, 丷
佳	亻, 圭	亻, 圭	㇒, 丨, 圭
家	宀, 豕	宀, 豕	冖, 丶, 一, ㇆, ㇒, ㇒, 冫
加	力, 口	力, 口	㇆, 丿, 口
荚	艹, 夹	艹, 人, 二, 丷	艹, 人, 二, 丷
颊	夹, 页	人, 二, 丷, 页	人, 二, 丷, 一, 丿, 冂, 人
贾	覀, 贝	覀, 贝	覀, 冂, 人
甲	冂, No glyph available	冂, 二, 丨	冂, 二, 丨
钾	钅, 甲	钅, 冂, 二, 丨	丿, 一, 乚, 二, 冂, 二, 丨
假	亻, 叚	亻, 尸, 二, No glyph availabl, 又	㇒, 丨, 丨, 匚, 二, 匚, ㇇, ㇏
稼	禾, 家	禾, 宀, 豕	㇒, 一, 丨, 八, 冖, 丶, 一, ㇆, ㇒, ㇒, 冫
价	亻, 介	亻, 人, No glyph availabl	㇒, 丨, 人, 丨
架	加, 木	力, 口, 木	㇆, 丿, 口, 一, 丨, 八
驾	加, 马	力, 口, 马	㇆, 丿, 口, ㇕, ㇉, 一
嫁	女, 家	女, 宀, 豕	㇛, 一, 丿, 冖, 丶, 一, ㇆, ㇒, ㇒, 冫
歼	歹, 千	歹, ㇒, 十	一, 夕, ㇒, 一, 丨
监	No glyph available, 皿	丨, 丨, 丿, 一, 丶, 皿	丨, 丨, 丿, 一, 丶, 冂, 丨, 一
坚	No glyph available, 土	丨, 丨, 又, 土	丨, 丨, ㇇, ㇏, 一, 丨, 一
尖	小, 大	小, 大	亅, 八, 人, 一
笺	⺮, 戋	⺮, 戋	⺮, 戋
间	门, 日	门, 日	丶, 丨, ㇆, 口, 一
煎	前, 灬	丷, 一, 月, 刂, 灬	丷, 一, 冂, 二, 亅, 丨, 灬
兼	䒑, No glyph available	丷, 一, No glyph availabl, 八, ⺕	丷, 一, 丨, 八, 匚, 一
肩	户, 月	户, 月	丨, 匚, 丶, 冂, 二
艰	又, 艮	又, 艮	㇇, ㇏, 丨, ㇕, 二, 乚, 冫
奸	女, 干	女, 干	㇛, 一, 丿, 一, 一, 丨
缄	纟, 咸	纟, 厂, 戈, 一, 口	㇛, 一, 厂, 戈, 一, 口
茧	艹, 虫	艹, 虫	艹, 口, 丨, 𠂉
检	木, 佥	木, 人, 一, ⺍, 一	一, 丨, 八, 人, 一, ⺍, 一
柬	木, No glyph available	木, 口, 丨, 丷	一, 丨, 八, 口, 丨, 丷
碱	石, 咸	石, 厂, 戈, 一, 口	一, 丿, 口, 厂, 戈, 一, 口
拣	扌, No glyph available	扌, 乚, 一, ㇆, 八	亅, 二, 乚, 一, ㇆, 八
捡	扌, 佥	扌, 人, 一, ⺍, 一	亅, 二, 人, 一, ⺍, 一
简	⺮, 间	⺮, 门, 日	⺮, 丶, 丨, ㇆, 口, 一
俭	亻, 佥	亻, 人, 一, ⺍, 一	㇒, 丨, 人, 一, ⺍, 一
剪	前, 刀	丷, 一, 月, 刂, 刀	丷, 一, 冂, 二, 亅, 丨, ㇆, 丿
减	冫, 咸	冫, 厂, 戈, 一, 口	丶, ㇀, 厂, 戈, 一, 口
荐	艹, 存	艹, 𠂇, 亻, 子	艹, 𠂇, ㇒, 丨, ㇇, 亅, 一
槛	木, 监	木, 丨, 丨, 丿, 一, 丶, 皿	一, 丨, 八, 丨, 丨, 丿, 一, 丶, 冂, 丨, 一
鉴	No glyph available, 金	丨, 丨, 丿, 一, 丶, 金	丨, 丨, 丿, 一, 丶, 人, 一, 一, 丨, 一, 丷
践	⻊, 戋	⻊, 戋	口, 丨, 一, 丨, 一, 戋
贱	贝, 戋	贝, 戋	冂, 人, 戋
见	冂, 儿	见	冂, 丿, 乚
键	钅, 建	钅, 廴, 聿	丿, 一, 乚, 二, ㇋, ㇏, 匚, 一, 丨, 二, 丨
箭	⺮, 前	⺮, 丷, 一, 月, 刂	⺮, 丷, 一, 冂, 二, 亅, 丨
件	亻, 牛	亻, 牛	㇒, 丨, 二, 丨, ㇒
健	亻, 建	亻, 廴, 聿	㇒, 丨, ㇋, ㇏, 匚, 一, 丨, 二, 丨
舰	舟, 见	舟, 见	冂, 丶, ⺀, 一, 冂, 丿, 乚
剑	佥, 刂	人, 一, ⺍, 一, 刂	人, 一, ⺍, 一, 亅, 丨
饯	饣, 戋	饣, 戋	⺈, 乚, 戋
渐	氵, 斩	氵, 车, 斤	⺀, ㇀, 乚, 一, 一, 丨, 丿, ㇒, 一, 丨
溅	氵, 贱	氵, 贝, 戋	⺀, ㇀, 冂, 人, 戋
涧	氵, 间	氵, 门, 日	⺀, ㇀, 丶, 丨, ㇆, 口, 一
建	廴, 聿	廴, 聿	㇋, ㇏, 匚, 一, 丨, 二, 丨
僵	亻, 畺	亻, 一, 二, 畕	㇒, 丨, 一, 二, 畕
姜	羊, 女	羊, 女	一, 二, 丨, 丷, ㇛, 一, 丿
将	丬, 𪨃	丬, 小, 扌, 亠, 从, 十	一, 丶, 丨, 亅, 八, 亅, 二, 一, 丶, 从, 一, 丨
浆	No glyph available, 水	丬, 夕, 水	一, 丶, 丨, 夕, 亅, ㇇, 冫
江	氵, 工	氵, 工	⺀, ㇀, 一, 丨, 一
疆	No glyph available, 畺	弓, 土, 一, 二, 畕	匚, ㇉, 一, 丨, 一, 一, 二, 畕
蒋	艹, 将	艹, 丬, 小, 扌, 亠, 从, 十	艹, 一, 丶, 丨, 亅, 八, 亅, 二, 一, 丶, 从, 一, 丨
桨	No glyph available, 木	丬, 夕, 木	一, 丶, 丨, 夕, 一, 丨, 八
奖	No glyph available, 大	丬, 夕, 大	一, 丶, 丨, 夕, 人, 一
讲	讠, 井	讠, No glyph availabl, 二	㇊, 丶, 丨, 二
匠	匚, 斤	匚, 斤	一, ㇗, 丿, ㇒, 一, 丨
酱	No glyph available, 酉	丬, 夕, 酉	一, 丶, 丨, 夕, 一, 丿, 乚, 口, 一
降	阝, 夅	阝, 夂, 十, ㇗, 丨	丨, ㇌, ㇇, ㇏, ㇒, 一, 丨, ㇗, 丨
蕉	艹, 焦	艹, 隹, 灬	艹, ㇒, 丨, 一, 二, 丨, 一, 丶, 灬
椒	木, 叔	木, ⺊, 一, 小, 又	一, 丨, 八, 丨, 一, 一, 亅, 八, ㇇, ㇏
礁	石, 焦	石, 隹, 灬	一, 丿, 口, ㇒, 丨, 一, 二, 丨, 一, 丶, 灬
焦	隹, 灬	隹, 灬	㇒, 丨, 一, 二, 丨, 一, 丶, 灬
胶	月, 交	月, 亠, 八, 乂	冂, 二, 一, 丶, 八, 乂
交	六, 乂	亠, 八, 乂	一, 丶, 八, 乂
郊	交, 阝	亠, 八, 乂, 阝	一, 丶, 八, 乂, 丨, ㇌
浇	氵, 尧	氵, No glyph availabl, 一, 儿	⺀, ㇀, ㇂, 一, ㇒, 一, 丿, 乚
骄	马, 乔	马, ㇒, 大, No glyph availabl	㇕, ㇉, 一, ㇒, 人, 一, 丨
娇	女, 乔	女, ㇒, 大, No glyph availabl	㇛, 一, 丿, ㇒, 人, 一, 丨
嚼	口, 爵	口, 爫, 罒, 丨, 彐, 乚, 丶, 寸	口, 爫, 口, 丨, 丨, ㇕, 二, 乚, 丶, 𠂇, 亅, 丶
搅	扌, 觉	扌, ⺍, 冖, 见	亅, 二, ⺍, 冖, 冂, 丿, 乚
铰	钅, 交	钅, 亠, 八, 乂	丿, 一, 乚, 二, 一, 丶, 八, 乂
矫	矢, 乔	矢, ㇒, 大, No glyph availabl	丿, 一, 人, 一, ㇒, 人, 一, 丨
侥	亻, 尧	亻, No glyph availabl, 一, 儿	㇒, 丨, ㇂, 一, ㇒, 一, 丿, 乚
脚	月, 却	月, 土, 厶, 卩	冂, 二, 一, 丨, 一, ㇛, 丶, 丨, ㇆
狡	犭, 交	犭, 亠, 八, 乂	㇁, ㇒, 一, 丶, 八, 乂
角	⺈, 用	角	⺈, 冂, 二, 丨
饺	饣, 交	饣, 亠, 八, 乂	⺈, 乚, 一, 丶, 八, 乂
缴	纟, 敫	纟, 白, 方, ⺙	㇛, 一, 口, 一, ㇒, 一, 丶, 丿, ㇆, 丿, 一, 乂
绞	纟, 交	纟, 亠, 八, 乂	㇛, 一, 一, 丶, 八, 乂
剿	巢, 刂	巛, 田, 木, 刂	巛, 冂, 一, 丨, 一, 一, 丨, 八, 亅, 丨
教	孝, ⺙	耂, 子, ⺙	耂, ㇇, 亅, 一, 丿, 一, 乂
酵	酉, 孝	酉, 耂, 子	一, 丿, 乚, 口, 一, 耂, ㇇, 亅, 一
轿	车, 乔	车, ㇒, 大, No glyph availabl	乚, 一, 一, 丨, ㇒, 人, 一, 丨
较	车, 交	车, 亠, 八, 乂	乚, 一, 一, 丨, 一, 丶, 八, 乂
叫	口, 丩	口, 丨, ㇙	口, 丨, ㇙
窖	穴, 告	穴, ⺧, 口	冖, 丶, 八, ⺧, 口
揭	扌, 曷	扌, 曰, 勹, 人, ㇗	亅, 二, 口, 一, ㇆, ㇒, 人, ㇗
接	扌, 妾	扌, 立, 女	亅, 二, 一, 丶, 丷, 一, ㇛, 一, 丿
皆	比, 白	比, 白	比, 口, 一, ㇒
秸	禾, 吉	禾, 士, 口	㇒, 一, 丨, 八, 一, 丨, 一, 口
街	行, 圭	行, 圭	㇒, 丨, 二, 亅, 圭
阶	阝, 介	阝, 人, No glyph availabl	丨, ㇌, 人, 丨
截	𢦏, 隹	土, 戈, 隹	一, 丨, 一, 戈, ㇒, 丨, 一, 二, 丨, 一, 丶
劫	去, 力	土, 厶, 力	一, 丨, 一, ㇛, 丶, ㇆, 丿
节	艹, No glyph available	艹, ㇆, 丨	艹, ㇆, 丨
桔	木, 吉	木, 士, 口	一, 丨, 八, 一, 丨, 一, 口
杰	木, 灬	木, 灬	一, 丨, 八, 灬
捷	扌, 疌	扌, 十, ⺺, 龰	亅, 二, 一, 丨, 匚, 一, 丨, 龰
睫	目, 疌	目, 十, ⺺, 龰	口, 二, 一, 丨, 匚, 一, 丨, 龰
竭	立, 曷	立, 曰, 勹, 人, ㇗	一, 丶, 丷, 一, 口, 一, ㇆, ㇒, 人, ㇗
洁	氵, 吉	氵, 士, 口	⺀, ㇀, 一, 丨, 一, 口
结	纟, 吉	纟, 士, 口	㇛, 一, 一, 丨, 一, 口
解	角, No glyph available	角, 刀, 牛	⺈, 冂, 二, 丨, ㇆, 丿, 二, 丨, ㇒
姐	女, 且	女, 月, 一	㇛, 一, 丿, 冂, 二, 一
戒	戈, 艹	戈, 艹	戈, 艹
藉	艹, 耤	艹, 耒, 艹, 一, 日	艹, 一, 二, 丨, 八, 艹, 一, 口, 一
芥	艹, 介	艹, 人, No glyph availabl	艹, 人, 丨
界	田, 介	田, 人, No glyph availabl	冂, 一, 丨, 一, 人, 丨
借	亻, 昔	亻, 艹, 一, 日	㇒, 丨, 艹, 一, 口, 一
介	人, No glyph available	人, No glyph availabl	人, 丨
疥	疒, 介	疒, 人, No glyph availabl	一, 丶, 厂, 丶, 人, 丨
诫	讠, 戒	讠, 戈, 艹	㇊, 丶, 戈, 艹
届	尸, 由	尸, 二, 丨, 凵	丨, 匚, 二, 丨, 凵
巾	冂, 丨	巾	冂, 丨
筋	⺮, 肋	⺮, 月, 力	⺮, 冂, 二, ㇆, 丿
斤	⺁, 丅	斤	丿, ㇒, 一, 丨
金	全, 丷	金	人, 一, 一, 丨, 一, 丷
今	亽, ㇇	人, 丶, ㇇	人, 丶, ㇇
津	氵, 聿	氵, 聿	⺀, ㇀, 匚, 一, 丨, 二, 丨
襟	衤, 禁	衤, 林, 示	一, 一, 丨, 一, 丶, 戈, 丨, 冫, 林, 二, 亅, 八
紧	No glyph available, 糸	丨, 丨, 又, 糸	丨, 丨, ㇇, ㇏, ㇛, 丶, 亅, 八
锦	钅, 帛	钅, 白, 巾	丿, 一, 乚, 二, 口, 一, ㇒, 冂, 丨
仅	亻, 又	亻, 又	㇒, 丨, ㇇, ㇏
谨	讠, 堇	讠, 廿, 口, 丨, 王	㇊, 丶, 卄, 一, 口, 丨, 一, 一, 丨, 一
进	辶, 井	辶, No glyph availabl, 二	丶, ㇆, ㇝, 丨, 二
靳	革, 斤	革, 斤	卄, 一, 口, 丨, 一, 丨, 丿, ㇒, 一, 丨
晋	亚, 日	一, No glyph availabl, 丷, 一, 日	一, 丨, 丷, 一, 口, 一
禁	林, 示	林, 示	林, 二, 亅, 八
近	辶, 斤	辶, 斤	丶, ㇆, ㇝, 丿, ㇒, 一, 丨
烬	火, 尽	火, 尸, ㇏, ⺀	丿, 丶, 冫, 丨, 匚, ㇏, ⺀
浸	氵, No glyph available	氵, 彐, 冖, 又	⺀, ㇀, ㇕, 二, 冖, ㇇, ㇏
尽	尺, ⺀	尸, ㇏, ⺀	丨, 匚, ㇏, ⺀
劲	No glyph available, 力	龴, 工, 力	龴, 一, 丨, 一, ㇆, 丿
荆	艹, 刑	艹, 一, 廾, 刂	艹, 一, 廾, 亅, 丨
兢	克	兢	兢
茎	艹, No glyph available	艹, 龴, 工	艹, 龴, 一, 丨, 一
睛	目, 青	目, 青	口, 二, 龶, 冂, 二
晶	日	晶	晶
鲸	鱼, 京	鱼, 亠, 口, 小	⺈, 冂, 一, 丨, 一, 一, 一, 丶, 口, 亅, 八
京	No glyph available, 小	亠, 口, 小	一, 丶, 口, 亅, 八
惊	忄, 京	忄, 亠, 口, 小	丨, 八, 一, 丶, 口, 亅, 八
精	米, 青	米, 青	一, 丨, 八, 丷, 龶, 冂, 二
粳	米, 更	米, 一, 日, 丨, 乂	一, 丨, 八, 丷, 一, 口, 一, 丨, 乂
经	纟, No glyph available	纟, 龴, 工	㇛, 一, 龴, 一, 丨, 一
井	No glyph available, 二	No glyph availabl, 二	丨, 二
警	敬, 言	艹, 勹, 口, ⺙, 言	艹, ㇆, ㇒, 口, 丿, 一, 乂, 一, 丶, 二, 口
景	日, 京	日, 亠, 口, 小	口, 一, 一, 丶, 口, 亅, 八
颈	No glyph available, 页	龴, 工, 页	龴, 一, 丨, 一, 一, 丿, 冂, 人
静	青, 争	青, ⺈, ⺕, 亅	龶, 冂, 二, ⺈, 匚, 一, 亅
境	土, 竟	土, 音, 儿	一, 丨, 一, 一, 丶, 丷, 一, 口, 一, 丿, 乚
敬	苟, ⺙	艹, 勹, 口, ⺙	艹, ㇆, ㇒, 口, 丿, 一, 乂
镜	钅, 竟	钅, 音, 儿	丿, 一, 乚, 二, 一, 丶, 丷, 一, 口, 一, 丿, 乚
径	彳, No glyph available	彳, 龴, 工	㇒, 丨, 龴, 一, 丨, 一
痉	疒, No glyph available	疒, 龴, 工	一, 丶, 厂, 丶, 龴, 一, 丨, 一
靖	立, 青	立, 青	一, 丶, 丷, 一, 龶, 冂, 二
竟	音, 儿	音, 儿	一, 丶, 丷, 一, 口, 一, 丿, 乚
竞	立, 兄	立, 口, 儿	一, 丶, 丷, 一, 口, 丿, 乚
净	冫, 争	冫, ⺈, ⺕, 亅	丶, ㇀, ⺈, 匚, 一, 亅
炯	火, 冋	火, 冂, 口	丿, 丶, 冫, 冂, 口
窘	穴, 君	穴, ⺕, 丨, 口	冖, 丶, 八, 匚, 一, 丨, 口
揪	扌, 秋	扌, 禾, 火	亅, 二, ㇒, 一, 丨, 八, 丿, 丶, 冫
究	穴, 九	穴, 丿, ㇈	冖, 丶, 八, 丿, ㇈
纠	纟, 丩	纟, 丨, ㇙	㇛, 一, 丨, ㇙
玖	王, 久	王, 勹, ㇏	一, 一, 丨, 一, ㇆, ㇒, ㇏
韭	非, 一	韭	非, 一
久	勹, ㇏	勹, ㇏	㇆, ㇒, ㇏
灸	久, 火	勹, ㇏, 火	㇆, ㇒, ㇏, 丿, 丶, 冫
九	丿, ㇈	丿, ㇈	丿, ㇈
酒	氵, 酉	氵, 酉	⺀, ㇀, 一, 丿, 乚, 口, 一
厩	厂, 既	厂, 丨, 彐, 乚, 丶, 旡	厂, 丨, ㇕, 二, 乚, 丶, 一, 丨, ㇜, 乚
救	求, ⺙	𠂇, 丶, 氺, ⺙	𠂇, 丶, 亅, 丶, ㇀, 冫, 丿, 一, 乂
旧	丨, 日	丨, 日	丨, 口, 一
臼	彐	臼	臼
舅	臼, 男	臼, 田, 力	臼, 冂, 一, 丨, 一, ㇆, 丿
咎	处, 口	夂, 卜, 口	㇇, ㇏, ㇒, 丨, 丶, 口
就	京, 尤	亠, 口, 小, 尢, 丶	一, 丶, 口, 亅, 八, 𠂇, 乚, 丶
疚	疒, 久	疒, 勹, ㇏	一, 丶, 厂, 丶, ㇆, ㇒, ㇏
鞠	革, 匊	革, 勹, 米	卄, 一, 口, 丨, 一, 丨, ㇆, ㇒, 一, 丨, 八, 丷
拘	扌, 句	扌, 勹, 口	亅, 二, ㇆, ㇒, 口
狙	犭, 且	犭, 月, 一	㇁, ㇒, 冂, 二, 一
疽	疒, 且	疒, 月, 一	一, 丶, 厂, 丶, 冂, 二, 一
居	尸, 古	尸, 十, 口	丨, 匚, 一, 丨, 口
驹	马, 句	马, 勹, 口	㇕, ㇉, 一, ㇆, ㇒, 口
菊	艹, 匊	艹, 勹, 米	艹, ㇆, ㇒, 一, 丨, 八, 丷
局	尸, No glyph available	尸, ㇆, 口	丨, 匚, ㇆, 口
咀	口, 且	口, 月, 一	口, 冂, 二, 一
矩	矢, 巨	矢, 匚, No glyph availabl	丿, 一, 人, 一, 一, ㇗, 匚
举	兴, No glyph available	⺍, 一, 八, 二, 丨	⺍, 一, 八, 二, 丨
沮	氵, 且	氵, 月, 一	⺀, ㇀, 冂, 二, 一
聚	取, 乑	耳, 又, 乑	二, 丨, 二, ㇇, ㇏, 乑
拒	扌, 巨	扌, 匚, No glyph availabl	亅, 二, 一, ㇗, 匚
据	扌, 居	扌, 尸, 十, 口	亅, 二, 丨, 匚, 一, 丨, 口
巨	匚, No glyph available	匚, No glyph availabl	一, ㇗, 匚
具	目, No glyph available	目, 一, 八	口, 二, 一, 八
距	⻊, 巨	⻊, 匚, No glyph availabl	口, 丨, 一, 丨, 一, 一, ㇗, 匚
踞	⻊, 居	⻊, 尸, 十, 口	口, 丨, 一, 丨, 一, 丨, 匚, 一, 丨, 口
锯	钅, 居	钅, 尸, 十, 口	丿, 一, 乚, 二, 丨, 匚, 一, 丨, 口
俱	亻, 具	亻, 目, 一, 八	㇒, 丨, 口, 二, 一, 八
句	勹, 口	勹, 口	㇆, ㇒, 口
惧	忄, 具	忄, 目, 一, 八	丨, 八, 口, 二, 一, 八
炬	火, 巨	火, 匚, No glyph availabl	丿, 丶, 冫, 一, ㇗, 匚
剧	居, 刂	尸, 十, 口, 刂	丨, 匚, 一, 丨, 口, 亅, 丨
捐	扌, 肙	扌, 口, 月	亅, 二, 口, 冂, 二
鹃	肙, 鸟	口, 月, 鸟	口, 冂, 二, ㇆, ㇉, 丶, 丶, 一
娟	女, 肙	女, 口, 月	㇛, 一, 丿, 口, 冂, 二
倦	亻, 卷	亻, 二, 丨, 丷, 八, 乚, ㇆	㇒, 丨, 二, 丨, 丷, 八, 乚, ㇆
眷	龹, 目	二, 丨, 丷, 八, 目	二, 丨, 丷, 八, 口, 二
卷	龹, 㔾	二, 丨, 丷, 八, 乚, ㇆	二, 丨, 丷, 八, 乚, ㇆
绢	纟, 肙	纟, 口, 月	㇛, 一, 口, 冂, 二
撅	扌, 厥	扌, 厂, 丷, 一, 屮, 欠	亅, 二, 厂, 丷, 一, 丨, 凵, ⺈, 人
攫	扌, 矍	扌, 䀠, 隹, 又	亅, 二, 䀠, ㇒, 丨, 一, 二, 丨, 一, 丶, ㇇, ㇏
抉	扌, 夬	扌, No glyph availabl, 丨, 人	亅, 二, 匚, 丨, 人
掘	扌, 屈	扌, 尸, 出	亅, 二, 丨, 匚, 出
倔	亻, 屈	亻, 尸, 出	㇒, 丨, 丨, 匚, 出
爵	爫, No glyph available	爫, 罒, 丨, 彐, 乚, 丶, 寸	爫, 口, 丨, 丨, ㇕, 二, 乚, 丶, 𠂇, 亅, 丶
觉	No glyph available, 见	⺍, 冖, 见	⺍, 冖, 冂, 丿, 乚
决	冫, 夬	冫, No glyph availabl, 丨, 人	丶, ㇀, 匚, 丨, 人
诀	讠, 夬	讠, No glyph availabl, 丨, 人	㇊, 丶, 匚, 丨, 人
绝	纟, 色	纟, 色	㇛, 一, ⺈, 丨, 匚, 丨, 乚
均	土, 匀	土, 勹, 亠	一, 丨, 一, ㇆, ㇒, 一, 丶
菌	艹, 囷	艹, 囗, 禾	艹, 冂, 一, ㇒, 一, 丨, 八
钧	钅, 匀	钅, 勹, 亠	丿, 一, 乚, 二, ㇆, ㇒, 一, 丶
军	冖, 车	冖, 车	冖, 乚, 一, 一, 丨
君	尹, 口	⺕, 丨, 口	匚, 一, 丨, 口
峻	山, 夋	山, 厶, 八, 夂	丨, 凵, ㇛, 丶, 八, ㇇, ㇏, ㇒
俊	亻, 夋	亻, 厶, 八, 夂	㇒, 丨, ㇛, 丶, 八, ㇇, ㇏, ㇒
竣	立, 夋	立, 厶, 八, 夂	一, 丶, 丷, 一, ㇛, 丶, 八, ㇇, ㇏, ㇒
浚	氵, 夋	氵, 厶, 八, 夂	⺀, ㇀, ㇛, 丶, 八, ㇇, ㇏, ㇒
郡	君, 阝	⺕, 丨, 口, 阝	匚, 一, 丨, 口, 丨, ㇌
骏	马, 夋	马, 厶, 八, 夂	㇕, ㇉, 一, ㇛, 丶, 八, ㇇, ㇏, ㇒
喀	口, 客	口, 宀, 夂, 口	口, 冖, 丶, ㇇, ㇏, ㇒, 口
咖	口, 加	口, 力, 口	口, ㇆, 丿, 口
卡	上, 卜	⺊, 一, 卜	丨, 一, 一, 丨, 丶
咯	口, 各	口, 夂, 口	口, ㇇, ㇏, ㇒, 口
开	一, 廾	一, 廾	一, 廾
揩	扌, 皆	扌, 比, 白	亅, 二, 比, 口, 一, ㇒
楷	木, 皆	木, 比, 白	一, 丨, 八, 比, 口, 一, ㇒
凯	岂, 几	山, 己, 几	丨, 凵, 匚, 乚, 丿, ㇠
慨	忄, 既	忄, 丨, 彐, 乚, 丶, 旡	丨, 八, 丨, ㇕, 二, 乚, 丶, 一, 丨, ㇜, 乚
刊	干, 刂	干, 刂	一, 一, 丨, 亅, 丨
堪	土, 甚	土, 甘, 匚, 儿	一, 丨, 一, 艹, 二, 一, ㇗, 丿, 乚
勘	甚, 力	甘, 匚, 儿, 力	艹, 二, 一, ㇗, 丿, 乚, ㇆, 丿
坎	土, 欠	土, 欠	一, 丨, 一, ⺈, 人
砍	石, 欠	石, 欠	一, 丿, 口, ⺈, 人
看	龵, 目	龵, 目	龵, 口, 二
康	广, 隶	广, 隶	厂, 丶, 匚, 一, 丨, 亅, 丶, ㇀, 冫
慷	忄, 康	忄, 广, 隶	丨, 八, 厂, 丶, 匚, 一, 丨, 亅, 丶, ㇀, 冫
糠	米, 康	米, 广, 隶	一, 丨, 八, 丷, 厂, 丶, 匚, 一, 丨, 亅, 丶, ㇀, 冫
扛	扌, 工	扌, 工	亅, 二, 一, 丨, 一
抗	扌, 亢	扌, 亠, 几	亅, 二, 一, 丶, 丿, ㇠
亢	亠, 几	亠, 几	一, 丶, 丿, ㇠
炕	火, 亢	火, 亠, 几	丿, 丶, 冫, 一, 丶, 丿, ㇠
考	耂, 丂	耂, 一, ㇉	耂, 一, ㇉
拷	扌, 考	扌, 耂, 一, ㇉	亅, 二, 耂, 一, ㇉
烤	火, 考	火, 耂, 一, ㇉	丿, 丶, 冫, 耂, 一, ㇉
靠	⺧, 啡	⺧, 口, 非	⺧, 口, 非
坷	土, 可	土, 一, 亅, 口	一, 丨, 一, 一, 亅, 口
苛	艹, 可	艹, 一, 亅, 口	艹, 一, 亅, 口
柯	木, 可	木, 一, 亅, 口	一, 丨, 八, 一, 亅, 口
棵	木, 果	木, 田, 木	一, 丨, 八, 冂, 一, 丨, 一, 一, 丨, 八
磕	石, 盍	石, 土, 厶, 皿	一, 丿, 口, 一, 丨, 一, ㇛, 丶, 冂, 丨, 一
颗	果, 页	田, 木, 页	冂, 一, 丨, 一, 一, 丨, 八, 一, 丿, 冂, 人
科	禾, 斗	禾, 斗	㇒, 一, 丨, 八, 一, 丨, ⺀
壳	士, 冗	士, 冖, 几	一, 丨, 一, 冖, 丿, ㇠
咳	口, 亥	口, 亠, 丨, ㇙, 人	口, 一, 丶, 丨, ㇙, 人
可	丁, 口	一, 亅, 口	一, 亅, 口
渴	氵, 曷	氵, 曰, 勹, 人, ㇗	⺀, ㇀, 口, 一, ㇆, ㇒, 人, ㇗
克	古, 儿	十, 口, 儿	一, 丨, 口, 丿, 乚
刻	亥, 刂	亠, 丨, ㇙, 人, 刂	一, 丶, 丨, ㇙, 人, 亅, 丨
客	宀, 各	宀, 夂, 口	冖, 丶, ㇇, ㇏, ㇒, 口
课	讠, 果	讠, 田, 木	㇊, 丶, 冂, 一, 丨, 一, 一, 丨, 八
肯	止, 月	止, 月	丨, 一, 丨, 一, 冂, 二
啃	口, 肯	口, 止, 月	口, 丨, 一, 丨, 一, 冂, 二
垦	艮, 土	艮, 土	丨, ㇕, 二, 乚, 冫, 一, 丨, 一
恳	艮, 心	艮, 心	丨, ㇕, 二, 乚, 冫, 𠁼, ㇃
坑	土, 亢	土, 亠, 几	一, 丨, 一, 一, 丶, 丿, ㇠
吭	口, 亢	口, 亠, 几	口, 一, 丶, 丿, ㇠
空	穴, 工	穴, 工	冖, 丶, 八, 一, 丨, 一
恐	巩, 心	工, 几, 丶, 心	一, 丨, 一, 丿, ㇠, 丶, 𠁼, ㇃
孔	子, 乚	子, 乚	㇇, 亅, 一, 乚
控	扌, 空	扌, 穴, 工	亅, 二, 冖, 丶, 八, 一, 丨, 一
抠	扌, 区	扌, 匚, 乂	亅, 二, 一, ㇗, 乂
口	囗	口	口
扣	扌, 口	扌, 口	亅, 二, 口
寇	宀, No glyph available	宀, 二, 儿, 攴	冖, 丶, 二, 丿, 乚, 丨, 一, ㇇, ㇏
枯	木, 古	木, 十, 口	一, 丨, 八, 一, 丨, 口
哭	吅, 犬	吅, 犬	吅, 人, 一, 丶
窟	穴, 屈	穴, 尸, 出	冖, 丶, 八, 丨, 匚, 出
苦	艹, 古	艹, 十, 口	艹, 一, 丨, 口
酷	酉, 告	酉, ⺧, 口	一, 丿, 乚, 口, 一, ⺧, 口
库	广, 车	广, 车	厂, 丶, 乚, 一, 一, 丨
裤	衤, 库	衤, 广, 车	一, 一, 丨, 一, 丶, 戈, 丨, 冫, 厂, 丶, 乚, 一, 一, 丨
夸	大, 亏	大, 二, ㇉	人, 一, 二, ㇉
垮	土, 夸	土, 大, 二, ㇉	一, 丨, 一, 人, 一, 二, ㇉
挎	扌, 夸	扌, 大, 二, ㇉	亅, 二, 人, 一, 二, ㇉
跨	⻊, 夸	⻊, 大, 二, ㇉	口, 丨, 一, 丨, 一, 人, 一, 二, ㇉
胯	月, 夸	月, 大, 二, ㇉	冂, 二, 人, 一, 二, ㇉
块	土, 夬	土, No glyph availabl, 丨, 人	一, 丨, 一, 匚, 丨, 人
筷	⺮, 快	⺮, 忄, No glyph availabl, 丨, 人	⺮, 丨, 八, 匚, 丨, 人
侩	亻, 会	亻, 人, 二, 厶	㇒, 丨, 人, 二, ㇛, 丶
快	忄, 夬	忄, No glyph availabl, 丨, 人	丨, 八, 匚, 丨, 人
宽	宀, 苋	宀, 艹, 见	冖, 丶, 艹, 冂, 丿, 乚
款	No glyph available, 欠	士, 示, 欠	一, 丨, 一, 二, 亅, 八, ⺈, 人
匡	匚, 王	匚, 王	一, ㇗, 一, 一, 丨, 一
筐	⺮, 匡	⺮, 匚, 王	⺮, 一, ㇗, 一, 一, 丨, 一
狂	犭, 王	犭, 王	㇁, ㇒, 一, 一, 丨, 一
框	木, 匡	木, 匚, 王	一, 丨, 八, 一, ㇗, 一, 一, 丨, 一
矿	石, 广	石, 广	一, 丿, 口, 厂, 丶
眶	目, 匡	目, 匚, 王	口, 二, 一, ㇗, 一, 一, 丨, 一
旷	日, 广	日, 广	口, 一, 厂, 丶
况	冫, 兄	冫, 口, 儿	丶, ㇀, 口, 丿, 乚
亏	二, ㇉	二, ㇉	二, ㇉
盔	灰, 皿	𠂇, 火, 皿	𠂇, 丿, 丶, 冫, 冂, 丨, 一
岿	山, 归	山, No glyph availabl, 彐	丨, 凵, 丨, 丨, ㇕, 二
窥	穴, 规	穴, 人, 二, 见	冖, 丶, 八, 人, 二, 冂, 丿, 乚
葵	艹, 癸	艹, 癶, 一, 大	艹, 癶, 一, 人, 一
奎	大, 圭	大, 圭	人, 一, 圭
魁	鬼, 斗	鬼, 斗	冂, 二, 丨, 丶, 乚, ㇛, 丶, 一, 丨, ⺀
傀	亻, 鬼	亻, 鬼	㇒, 丨, 冂, 二, 丨, 丶, 乚, ㇛, 丶
馈	饣, 贵	饣, 口, 丨, 一, 贝	⺈, 乚, 口, 丨, 一, 冂, 人
愧	忄, 鬼	忄, 鬼	丨, 八, 冂, 二, 丨, 丶, 乚, ㇛, 丶
溃	氵, 贵	氵, 口, 丨, 一, 贝	⺀, ㇀, 口, 丨, 一, 冂, 人
坤	土, 申	土, 日, 丨	一, 丨, 一, 口, 一, 丨
昆	日, 比	日, 比	口, 一, 比
捆	扌, 困	扌, 囗, 木	亅, 二, 冂, 一, 一, 丨, 八
困	囗, 木	囗, 木	冂, 一, 一, 丨, 八
括	扌, 舌	扌, 舌	亅, 二, ㇒, 一, 丨, 口
扩	扌, 广	扌, 广	亅, 二, 厂, 丶
廓	广, 郭	广, 亠, 口, 子, 阝	厂, 丶, 一, 丶, 口, ㇇, 亅, 一, 丨, ㇌
阔	门, 活	门, 氵, 舌	丶, 丨, ㇆, ⺀, ㇀, ㇒, 一, 丨, 口
垃	土, 立	土, 立	一, 丨, 一, 一, 丶, 丷, 一
拉	扌, 立	扌, 立	亅, 二, 一, 丶, 丷, 一
喇	口, 剌	口, 木, 口, 刂	口, 一, 丨, 八, 口, 亅, 丨
蜡	虫, 昔	虫, 艹, 一, 日	口, 丨, 𠂉, 艹, 一, 口, 一
腊	月, 昔	月, 艹, 一, 日	冂, 二, 艹, 一, 口, 一
辣	辛, 束	辛, 木, 口	一, 丶, 丷, 一, 一, 丨, 一, 丨, 八, 口
啦	口, 拉	口, 扌, 立	口, 亅, 二, 一, 丶, 丷, 一
莱	艹, 来	艹, 木, 一, 丷	艹, 一, 丨, 八, 一, 丷
来	未, 丷	木, 一, 丷	一, 丨, 八, 一, 丷
赖	束, 负	木, 口, ⺈, 贝	一, 丨, 八, 口, ⺈, 冂, 人
蓝	艹, 监	艹, 丨, 丨, 丿, 一, 丶, 皿	艹, 丨, 丨, 丿, 一, 丶, 冂, 丨, 一
婪	林, 女	林, 女	林, ㇛, 一, 丿
栏	木, 兰	木, 丷, 一, 二	一, 丨, 八, 丷, 一, 二
拦	扌, 兰	扌, 丷, 一, 二	亅, 二, 丷, 一, 二
篮	⺮, 监	⺮, 丨, 丨, 丿, 一, 丶, 皿	⺮, 丨, 丨, 丿, 一, 丶, 冂, 丨, 一
阑	门, 柬	门, 木, 口, 丨, 丷	丶, 丨, ㇆, 一, 丨, 八, 口, 丨, 丷
兰	丷, 三	丷, 一, 二	丷, 一, 二
澜	氵, 阑	氵, 门, 木, 口, 丨, 丷	⺀, ㇀, 丶, 丨, ㇆, 一, 丨, 八, 口, 丨, 丷
谰	讠, 阑	讠, 门, 木, 口, 丨, 丷	㇊, 丶, 丶, 丨, ㇆, 一, 丨, 八, 口, 丨, 丷
揽	扌, 览	扌, 丨, 丨, 丿, 一, 丶, 见	亅, 二, 丨, 丨, 丿, 一, 丶, 冂, 丿, 乚
览	No glyph available, 见	丨, 丨, 丿, 一, 丶, 见	丨, 丨, 丿, 一, 丶, 冂, 丿, 乚
懒	忄, 赖	忄, 木, 口, ⺈, 贝	丨, 八, 一, 丨, 八, 口, ⺈, 冂, 人
缆	纟, 览	纟, 丨, 丨, 丿, 一, 丶, 见	㇛, 一, 丨, 丨, 丿, 一, 丶, 冂, 丿, 乚
烂	火, 兰	火, 丷, 一, 二	丿, 丶, 冫, 丷, 一, 二
滥	氵, 监	氵, 丨, 丨, 丿, 一, 丶, 皿	⺀, ㇀, 丨, 丨, 丿, 一, 丶, 冂, 丨, 一
琅	王, 良	王, 艮, 丶	一, 一, 丨, 一, 丨, ㇕, 二, 乚, 冫, 丶
榔	木, 郎	木, 丨, 彐, 乚, 丶, 丶, 阝	一, 丨, 八, 丨, ㇕, 二, 乚, 丶, 丶, 丨, ㇌
狼	犭, 良	犭, 艮, 丶	㇁, ㇒, 丨, ㇕, 二, 乚, 冫, 丶
廊	广, 郎	广, 丨, 彐, 乚, 丶, 丶, 阝	厂, 丶, 丨, ㇕, 二, 乚, 丶, 丶, 丨, ㇌
郎	No glyph available, 阝	丨, 彐, 乚, 丶, 丶, 阝	丨, ㇕, 二, 乚, 丶, 丶, 丨, ㇌
朗	No glyph available, 月	丨, 彐, 乚, 丶, 丶, 月	丨, ㇕, 二, 乚, 丶, 丶, 冂, 二
浪	氵, 良	氵, 艮, 丶	⺀, ㇀, 丨, ㇕, 二, 乚, 冫, 丶
捞	扌, 劳	扌, 艹, 冖, 力	亅, 二, 艹, 冖, ㇆, 丿
劳	艹, No glyph available	艹, 冖, 力	艹, 冖, ㇆, 丿
牢	宀, 牛	宀, 牛	冖, 丶, 二, 丨, ㇒
老	耂, 匕	老	耂, 乚, ㇒
佬	亻, 老	亻, 老	㇒, 丨, 耂, 乚, ㇒
姥	女, 老	女, 老	㇛, 一, 丿, 耂, 乚, ㇒
酪	酉, 各	酉, 夂, 口	一, 丿, 乚, 口, 一, ㇇, ㇏, ㇒, 口
烙	火, 各	火, 夂, 口	丿, 丶, 冫, ㇇, ㇏, ㇒, 口
涝	氵, 劳	氵, 艹, 冖, 力	⺀, ㇀, 艹, 冖, ㇆, 丿
勒	革, 力	革, 力	卄, 一, 口, 丨, 一, 丨, ㇆, 丿
乐	No glyph available, 小	㇒, ㇗, 小	㇒, ㇗, 亅, 八
雷	雨, 田	雨, 田	一, 冂, 丨, 丶, ㇀, 冫, 冂, 一, 丨, 一
镭	钅, 雷	钅, 雨, 田	丿, 一, 乚, 二, 一, 冂, 丨, 丶, ㇀, 冫, 冂, 一, 丨, 一
蕾	艹, 雷	艹, 雨, 田	艹, 一, 冂, 丨, 丶, ㇀, 冫, 冂, 一, 丨, 一
磊	石	磊	磊
累	田, 糸	田, 糸	冂, 一, 丨, 一, ㇛, 丶, 亅, 八
儡	亻, 畾	亻, 畾	㇒, 丨, 畾
垒	厽, 土	厽, 土	厽, 一, 丨, 一
擂	扌, 雷	扌, 雨, 田	亅, 二, 一, 冂, 丨, 丶, ㇀, 冫, 冂, 一, 丨, 一
肋	月, 力	月, 力	冂, 二, ㇆, 丿
类	米, 大	米, 大	一, 丨, 八, 丷, 人, 一
泪	氵, 目	氵, 目	⺀, ㇀, 口, 二
棱	木, 夌	木, 土, 八, 夂	一, 丨, 八, 一, 丨, 一, 八, ㇇, ㇏, ㇒
楞	木, No glyph available	木, 罒, 方	一, 丨, 八, 口, 丨, 一, 丶, 丿, ㇆
冷	冫, 令	冫, 人, 丶, 龴	丶, ㇀, 人, 丶, 龴
厘	厂, 里	厂, 里	厂, 冂, 一, 丨, 一, 一, 丨, 一
梨	利, 木	禾, 刂, 木	㇒, 一, 丨, 八, 亅, 丨, 一, 丨, 八
犁	利, 牛	禾, 刂, 牛	㇒, 一, 丨, 八, 亅, 丨, 二, 丨, ㇒
黎	No glyph available, No glyph available	禾, 勹, ㇒, 人, 氺	㇒, 一, 丨, 八, ㇆, ㇒, ㇒, 人, 亅, 丶, ㇀, 冫
篱	⺮, 离	⺮, 亠, 凵, 乂, 禸	⺮, 一, 丶, 凵, 乂, ㇛, 丶, 冂
狸	犭, 里	犭, 里	㇁, ㇒, 冂, 一, 丨, 一, 一, 丨, 一
离	No glyph available, 禸	亠, 凵, 乂, 禸	一, 丶, 凵, 乂, ㇛, 丶, 冂
漓	氵, 离	氵, 亠, 凵, 乂, 禸	⺀, ㇀, 一, 丶, 凵, 乂, ㇛, 丶, 冂
理	王, 里	王, 里	一, 一, 丨, 一, 冂, 一, 丨, 一, 一, 丨, 一
李	木, 子	木, 子	一, 丨, 八, ㇇, 亅, 一
里	田, 土	里	冂, 一, 丨, 一, 一, 丨, 一
鲤	鱼, 里	鱼, 里	⺈, 冂, 一, 丨, 一, 一, 冂, 一, 丨, 一, 一, 丨, 一
礼	礻, 乚	礻, 乚	一, 一, 丨, 一, 丶, 戈, 丨, 丶, 乚
莉	艹, 利	艹, 禾, 刂	艹, ㇒, 一, 丨, 八, 亅, 丨
荔	艹, 劦	艹, 劦	艹, 劦
吏	No glyph available, 乂	十, 口, 丨, 乂	一, 丨, 口, 丨, 乂
栗	覀, 木	覀, 木	覀, 一, 丨, 八
丽	一, No glyph available	一, No glyph availabl	一, 冂, 丶
厉	厂, 万	厂, 一, 丿, ㇆	厂, 一, 丿, ㇆
励	厉, 力	厂, 一, 丿, ㇆, 力	厂, 一, 丿, ㇆, ㇆, 丿
砾	石, 乐	石, ㇒, ㇗, 小	一, 丿, 口, ㇒, ㇗, 亅, 八
历	厂, 力	厂, 力	厂, ㇆, 丿
利	禾, 刂	禾, 刂	㇒, 一, 丨, 八, 亅, 丨
例	亻, 列	亻, 歹, 刂	㇒, 丨, 一, 夕, 亅, 丨
俐	亻, 利	亻, 禾, 刂	㇒, 丨, ㇒, 一, 丨, 八, 亅, 丨
痢	疒, 利	疒, 禾, 刂	一, 丶, 厂, 丶, ㇒, 一, 丨, 八, 亅, 丨
立	亠, 䒑	立	一, 丶, 丷, 一
粒	米, 立	米, 立	一, 丨, 八, 丷, 一, 丶, 丷, 一
沥	氵, 历	氵, 厂, 力	⺀, ㇀, 厂, ㇆, 丿
隶	⺺, 氺	隶	匚, 一, 丨, 亅, 丶, ㇀, 冫
力	㇆, 丿	力	㇆, 丿
璃	王, 离	王, 亠, 凵, 乂, 禸	一, 一, 丨, 一, 一, 丶, 凵, 乂, ㇛, 丶, 冂
哩	口, 里	口, 里	口, 冂, 一, 丨, 一, 一, 丨, 一
俩	亻, 两	亻, 一, 从, 冂	㇒, 丨, 一, 从, 冂
联	耳, 关	耳, 丷, 一, 大	二, 丨, 二, 丷, 一, 人, 一
莲	艹, 连	艹, 辶, 车	艹, 丶, ㇆, ㇝, 乚, 一, 一, 丨
连	辶, 车	辶, 车	丶, ㇆, ㇝, 乚, 一, 一, 丨
镰	钅, 廉	钅, 广, 丷, 一, No glyph availabl, 八, ⺕	丿, 一, 乚, 二, 厂, 丶, 丷, 一, 丨, 八, 匚, 一
廉	广, 兼	广, 丷, 一, No glyph availabl, 八, ⺕	厂, 丶, 丷, 一, 丨, 八, 匚, 一
怜	忄, 令	忄, 人, 丶, 龴	丨, 八, 人, 丶, 龴
涟	氵, 连	氵, 辶, 车	⺀, ㇀, 丶, ㇆, ㇝, 乚, 一, 一, 丨
帘	穴, 巾	穴, 巾	冖, 丶, 八, 冂, 丨
敛	佥, ⺙	人, 一, ⺍, 一, ⺙	人, 一, ⺍, 一, 丿, 一, 乂
脸	月, 佥	月, 人, 一, ⺍, 一	冂, 二, 人, 一, ⺍, 一
链	钅, 连	钅, 辶, 车	丿, 一, 乚, 二, 丶, ㇆, ㇝, 乚, 一, 一, 丨
恋	亦, 心	亠, 丨, 亅, 八, 心	一, 丶, 丨, 亅, 八, 𠁼, ㇃
炼	火, No glyph available	火, 乚, 一, ㇆, 八	丿, 丶, 冫, 乚, 一, ㇆, 八
练	纟, No glyph available	纟, 乚, 一, ㇆, 八	㇛, 一, 乚, 一, ㇆, 八
粮	米, 良	米, 艮, 丶	一, 丨, 八, 丷, 丨, ㇕, 二, 乚, 冫, 丶
凉	冫, 京	冫, 亠, 口, 小	丶, ㇀, 一, 丶, 口, 亅, 八
梁	No glyph available, 木	氵, 刀, 八, 木	⺀, ㇀, ㇆, 丿, 八, 一, 丨, 八
粱	No glyph available, 米	氵, 刀, 八, 米	⺀, ㇀, ㇆, 丿, 八, 一, 丨, 八, 丷
良	艮, 丶	艮, 丶	丨, ㇕, 二, 乚, 冫, 丶
两	一, No glyph available	一, 从, 冂	一, 从, 冂
辆	车, 两	车, 一, 从, 冂	乚, 一, 一, 丨, 一, 从, 冂
量	日, No glyph available	日, 一, 里	口, 一, 一, 冂, 一, 丨, 一, 一, 丨, 一
晾	日, 京	日, 亠, 口, 小	口, 一, 一, 丶, 口, 亅, 八
亮	No glyph available, 几	亠, 口, 冖, 几	一, 丶, 口, 冖, 丿, ㇠
谅	讠, 京	讠, 亠, 口, 小	㇊, 丶, 一, 丶, 口, 亅, 八
撩	扌, 尞	扌, 大, 丷, 日, 小	亅, 二, 人, 一, 丷, 口, 一, 亅, 八
聊	耳, 卯	耳, 卯	二, 丨, 二, 卯
僚	亻, 尞	亻, 大, 丷, 日, 小	㇒, 丨, 人, 一, 丷, 口, 一, 亅, 八
疗	疒, 了	疒, ㇇, 亅	一, 丶, 厂, 丶, ㇇, 亅
燎	火, 尞	火, 大, 丷, 日, 小	丿, 丶, 冫, 人, 一, 丷, 口, 一, 亅, 八
寥	宀, 翏	宀, 羽, 人, 彡	冖, 丶, 羽, 人, 彡
辽	辶, 了	辶, ㇇, 亅	丶, ㇆, ㇝, ㇇, 亅
潦	氵, 尞	氵, 大, 丷, 日, 小	⺀, ㇀, 人, 一, 丷, 口, 一, 亅, 八
了	㇇, 亅	㇇, 亅	㇇, 亅
撂	扌, 畧	扌, 田, 夂, 口	亅, 二, 冂, 一, 丨, 一, ㇇, ㇏, ㇒, 口
镣	钅, 尞	钅, 大, 丷, 日, 小	丿, 一, 乚, 二, 人, 一, 丷, 口, 一, 亅, 八
廖	广, 翏	广, 羽, 人, 彡	厂, 丶, 羽, 人, 彡
料	米, 斗	米, 斗	一, 丨, 八, 丷, 一, 丨, ⺀
列	歹, 刂	歹, 刂	一, 夕, 亅, 丨
裂	列, 衣	歹, 刂, 衣	一, 夕, 亅, 丨, 一, 丶, ㇒, ㇗, 冫
烈	列, 灬	歹, 刂, 灬	一, 夕, 亅, 丨, 灬
劣	少, 力	小, 丿, 力	亅, 八, 丿, ㇆, 丿
猎	犭, 昔	犭, 艹, 一, 日	㇁, ㇒, 艹, 一, 口, 一
琳	王, 林	王, 林	一, 一, 丨, 一, 林
林	木	林	林
磷	石, 粦	石, 米, 舛	一, 丿, 口, 一, 丨, 八, 丷, 夕, 一, 丨, ㇗, 丨
霖	雨, 林	雨, 林	一, 冂, 丨, 丶, ㇀, 冫, 林
临	No glyph available, No glyph available	丨, 丨, 丿, 一, 丶, 口, 丨	丨, 丨, 丿, 一, 丶, 口, 丨
邻	令, 阝	人, 丶, 龴, 阝	人, 丶, 龴, 丨, ㇌
鳞	鱼, 粦	鱼, 米, 舛	⺈, 冂, 一, 丨, 一, 一, 一, 丨, 八, 丷, 夕, 一, 丨, ㇗, 丨
淋	氵, 林	氵, 林	⺀, ㇀, 林
凛	冫, 禀	冫, 亠, 回, 示	丶, ㇀, 一, 丶, 回, 二, 亅, 八
赁	任, 贝	亻, ㇒, 士, 贝	㇒, 丨, ㇒, 一, 丨, 一, 冂, 人
吝	文, 口	文, 口	一, 丶, 乂, 口
拎	扌, 令	扌, 人, 丶, 龴	亅, 二, 人, 丶, 龴
玲	王, 令	王, 人, 丶, 龴	一, 一, 丨, 一, 人, 丶, 龴
菱	艹, 夌	艹, 土, 八, 夂	艹, 一, 丨, 一, 八, ㇇, ㇏, ㇒
零	雨, 令	雨, 人, 丶, 龴	一, 冂, 丨, 丶, ㇀, 冫, 人, 丶, 龴
龄	齿, 令	齿, 人, 丶, 龴	丨, 一, 丨, 一, 凵, 人, 人, 丶, 龴
铃	钅, 令	钅, 人, 丶, 龴	丿, 一, 乚, 二, 人, 丶, 龴
伶	亻, 令	亻, 人, 丶, 龴	㇒, 丨, 人, 丶, 龴
羚	羊, 令	羊, 人, 丶, 龴	一, 二, 丨, 丷, 人, 丶, 龴
凌	冫, 夌	冫, 土, 八, 夂	丶, ㇀, 一, 丨, 一, 八, ㇇, ㇏, ㇒
灵	彐, 火	彐, 火	㇕, 二, 丿, 丶, 冫
陵	阝, 夌	阝, 土, 八, 夂	丨, ㇌, 一, 丨, 一, 八, ㇇, ㇏, ㇒
岭	山, 令	山, 人, 丶, 龴	丨, 凵, 人, 丶, 龴
领	令, 页	人, 丶, 龴, 页	人, 丶, 龴, 一, 丿, 冂, 人
另	口, 力	口, 力	口, ㇆, 丿
令	亽, 龴	人, 丶, 龴	人, 丶, 龴
溜	氵, 留	氵, 卯, 田	⺀, ㇀, 卯, 冂, 一, 丨, 一
琉	王, 㐬	王, 亠, 厶, 儿, 丨	一, 一, 丨, 一, 一, 丶, ㇛, 丶, 丿, 乚, 丨
榴	木, 留	木, 卯, 田	一, 丨, 八, 卯, 冂, 一, 丨, 一
硫	石, 㐬	石, 亠, 厶, 儿, 丨	一, 丿, 口, 一, 丶, ㇛, 丶, 丿, 乚, 丨
馏	饣, 留	饣, 卯, 田	⺈, 乚, 卯, 冂, 一, 丨, 一
留	卯, 田	卯, 田	卯, 冂, 一, 丨, 一
刘	文, 刂	文, 刂	一, 丶, 乂, 亅, 丨
瘤	疒, 留	疒, 卯, 田	一, 丶, 厂, 丶, 卯, 冂, 一, 丨, 一
流	氵, 㐬	氵, 亠, 厶, 儿, 丨	⺀, ㇀, 一, 丶, ㇛, 丶, 丿, 乚, 丨
柳	木, 卯	木, 卯	一, 丨, 八, 卯
六	亠, 八	亠, 八	一, 丶, 八
龙	No glyph available, 匕	龙	𠂇, 丶, 乚, ㇒
聋	龙, 耳	龙, 耳	𠂇, 丶, 乚, ㇒, 二, 丨, 二
咙	口, 龙	口, 龙	口, 𠂇, 丶, 乚, ㇒
笼	⺮, 龙	⺮, 龙	⺮, 𠂇, 丶, 乚, ㇒
窿	穴, 隆	穴, 阝, 夂, 一, 生	冖, 丶, 八, 丨, ㇌, ㇇, ㇏, ㇒, 一, 龶, ㇒
隆	阝, No glyph available	阝, 夂, 一, 生	丨, ㇌, ㇇, ㇏, ㇒, 一, 龶, ㇒
垄	龙, 土	龙, 土	𠂇, 丶, 乚, ㇒, 一, 丨, 一
拢	扌, 龙	扌, 龙	亅, 二, 𠂇, 丶, 乚, ㇒
陇	阝, 龙	阝, 龙	丨, ㇌, 𠂇, 丶, 乚, ㇒
楼	木, 娄	木, 米, 女	一, 丨, 八, 一, 丨, 八, 丷, ㇛, 一, 丿
娄	米, 女	米, 女	一, 丨, 八, 丷, ㇛, 一, 丿
搂	扌, 娄	扌, 米, 女	亅, 二, 一, 丨, 八, 丷, ㇛, 一, 丿
篓	⺮, 娄	⺮, 米, 女	⺮, 一, 丨, 八, 丷, ㇛, 一, 丿
漏	氵, 屚	氵, 尸, 雨	⺀, ㇀, 丨, 匚, 一, 冂, 丨, 丶, ㇀, 冫
陋	阝, No glyph available	阝, ㇗, 一, 人, 冂	丨, ㇌, ㇗, 一, 人, 冂
芦	艹, 户	艹, 户	艹, 丨, 匚, 丶
卢	⺊, 尸	⺊, 尸	丨, 一, 丨, 匚
颅	卢, 页	⺊, 尸, 页	丨, 一, 丨, 匚, 一, 丿, 冂, 人
庐	广, 户	广, 户	厂, 丶, 丨, 匚, 丶
炉	火, 户	火, 户	丿, 丶, 冫, 丨, 匚, 丶
掳	扌, 虏	扌, 虍, 力	亅, 二, 丨, 一, 冖, 乚, 一, ㇆, 丿
卤	⺊, 龱	卤	丨, 一, 冂, 一, 乂
虏	虍, 力	虍, 力	丨, 一, 冖, 乚, 一, ㇆, 丿
鲁	鱼, 日	鱼, 日	⺈, 冂, 一, 丨, 一, 一, 口, 一
麓	林, 鹿	林, 鹿	林, 厂, 丶, 覀, 比
碌	石, 录	石, 彐, 氺	一, 丿, 口, ㇕, 二, 亅, 丶, ㇀, 冫
露	雨, 路	雨, ⻊, 夂, 口	一, 冂, 丨, 丶, ㇀, 冫, 口, 丨, 一, 丨, 一, ㇇, ㇏, ㇒, 口
路	⻊, 各	⻊, 夂, 口	口, 丨, 一, 丨, 一, ㇇, ㇏, ㇒, 口
赂	贝, 各	贝, 夂, 口	冂, 人, ㇇, ㇏, ㇒, 口
鹿	No glyph available, 比	鹿	厂, 丶, 覀, 比
潞	氵, 路	氵, ⻊, 夂, 口	⺀, ㇀, 口, 丨, 一, 丨, 一, ㇇, ㇏, ㇒, 口
禄	礻, 录	礻, 彐, 氺	一, 一, 丨, 一, 丶, 戈, 丨, 丶, ㇕, 二, 亅, 丶, ㇀, 冫
录	彐, 氺	彐, 氺	㇕, 二, 亅, 丶, ㇀, 冫
陆	阝, 击	阝, 二, 丨, 山	丨, ㇌, 二, 丨, 丨, 凵
戮	翏, 戈	羽, 人, 彡, 戈	羽, 人, 彡, 戈
驴	马, 户	马, 户	㇕, ㇉, 一, 丨, 匚, 丶
吕	口	吕	吕
铝	钅, 吕	钅, 吕	丿, 一, 乚, 二, 吕
侣	亻, 吕	亻, 吕	㇒, 丨, 吕
旅	方, No glyph available	方, 丿, 一, 氏	一, 丶, 丿, ㇆, 丿, 一, ㇒, ㇗, ㇂, 一
履	尸, 復	尸, 彳, 丿, 一, 日, 夂	丨, 匚, ㇒, 丨, 丿, 一, 口, 一, ㇇, ㇏, ㇒
屡	尸, 娄	尸, 米, 女	丨, 匚, 一, 丨, 八, 丷, ㇛, 一, 丿
缕	纟, 娄	纟, 米, 女	㇛, 一, 一, 丨, 八, 丷, ㇛, 一, 丿
虑	虍, 心	虍, 心	丨, 一, 冖, 乚, 一, 𠁼, ㇃
氯	气, 录	气, 彐, 氺	丿, 一, 一, ㇠, ㇕, 二, 亅, 丶, ㇀, 冫
律	彳, 聿	彳, 聿	㇒, 丨, 匚, 一, 丨, 二, 丨
率	亠, No glyph available	亠, 幺, 冫, No glyph availabl, 十	一, 丶, ㇛, 丶, 丶, ㇀, 冫, 一, 丨
滤	氵, 虑	氵, 虍, 心	⺀, ㇀, 丨, 一, 冖, 乚, 一, 𠁼, ㇃
绿	纟, 录	纟, 彐, 氺	㇛, 一, ㇕, 二, 亅, 丶, ㇀, 冫
峦	亦, 山	亠, 丨, 亅, 八, 山	一, 丶, 丨, 亅, 八, 丨, 凵
挛	亦, 手	亠, 丨, 亅, 八, 手	一, 丶, 丨, 亅, 八, ㇒, 亅, 二
孪	亦, 子	亠, 丨, 亅, 八, 子	一, 丶, 丨, 亅, 八, ㇇, 亅, 一
滦	氵, 栾	氵, 亠, 丨, 亅, 八, 木	⺀, ㇀, 一, 丶, 丨, 亅, 八, 一, 丨, 八
卵	卪	卵	卵
乱	舌, 乚	舌, 乚	㇒, 一, 丨, 口, 乚
掠	扌, 京	扌, 亠, 口, 小	亅, 二, 一, 丶, 口, 亅, 八
略	田, 各	田, 夂, 口	冂, 一, 丨, 一, ㇇, ㇏, ㇒, 口
抡	扌, 仑	扌, 人, 匕	亅, 二, 人, 乚, ㇒
轮	车, 仑	车, 人, 匕	乚, 一, 一, 丨, 人, 乚, ㇒
伦	亻, 仑	亻, 人, 匕	㇒, 丨, 人, 乚, ㇒
仑	人, 匕	人, 匕	人, 乚, ㇒
沦	氵, 仑	氵, 人, 匕	⺀, ㇀, 人, 乚, ㇒
纶	纟, 仑	纟, 人, 匕	㇛, 一, 人, 乚, ㇒
论	讠, 仑	讠, 人, 匕	㇊, 丶, 人, 乚, ㇒
萝	艹, 罗	艹, 罒, 夕	艹, 口, 丨, 夕
螺	虫, 累	虫, 田, 糸	口, 丨, 𠂉, 冂, 一, 丨, 一, ㇛, 丶, 亅, 八
罗	罒, 夕	罒, 夕	口, 丨, 夕
逻	辶, 罗	辶, 罒, 夕	丶, ㇆, ㇝, 口, 丨, 夕
锣	钅, 罗	钅, 罒, 夕	丿, 一, 乚, 二, 口, 丨, 夕
箩	⺮, 罗	⺮, 罒, 夕	⺮, 口, 丨, 夕
骡	马, 累	马, 田, 糸	㇕, ㇉, 一, 冂, 一, 丨, 一, ㇛, 丶, 亅, 八
裸	衤, 果	衤, 田, 木	一, 一, 丨, 一, 丶, 戈, 丨, 冫, 冂, 一, 丨, 一, 一, 丨, 八
落	艹, 洛	艹, 氵, 夂, 口	艹, ⺀, ㇀, ㇇, ㇏, ㇒, 口
洛	氵, 各	氵, 夂, 口	⺀, ㇀, ㇇, ㇏, ㇒, 口
骆	马, 各	马, 夂, 口	㇕, ㇉, 一, ㇇, ㇏, ㇒, 口
络	纟, 各	纟, 夂, 口	㇛, 一, ㇇, ㇏, ㇒, 口
妈	女, 马	女, 马	㇛, 一, 丿, ㇕, ㇉, 一
麻	广, 林	麻	厂, 丶, 林
玛	王, 马	王, 马	一, 一, 丨, 一, ㇕, ㇉, 一
码	石, 马	石, 马	一, 丿, 口, ㇕, ㇉, 一
蚂	虫, 马	虫, 马	口, 丨, 𠂉, ㇕, ㇉, 一
马	No glyph available, 一	马	㇕, ㇉, 一
骂	吅, 马	吅, 马	吅, ㇕, ㇉, 一
嘛	口, 麻	口, 麻	口, 厂, 丶, 林
吗	口, 马	口, 马	口, ㇕, ㇉, 一
埋	土, 里	土, 里	一, 丨, 一, 冂, 一, 丨, 一, 一, 丨, 一
买	㇖, 头	㇖, 大, ⺀	㇖, 人, 一, ⺀
麦	龶, 夂	麦	龶, ㇇, ㇏, ㇒
卖	十, 买	十, ㇖, 大, ⺀	一, 丨, ㇖, 人, 一, ⺀
迈	辶, 万	辶, 一, 丿, ㇆	丶, ㇆, ㇝, 一, 丿, ㇆
脉	月, 永	月, ㇆, ㇇, No glyph availabl, 丶	冂, 二, ㇆, ㇇, 冫, 丶
瞒	目, No glyph available	目, 艹, 一, 从, 冂	口, 二, 艹, 一, 从, 冂
馒	饣, 曼	饣, 日, 罒, 又	⺈, 乚, 口, 一, 口, 丨, ㇇, ㇏
蛮	亦, 虫	亠, 丨, 亅, 八, 虫	一, 丶, 丨, 亅, 八, 口, 丨, 𠂉
满	氵, No glyph available	氵, 艹, 一, 从, 冂	⺀, ㇀, 艹, 一, 从, 冂
蔓	艹, 曼	艹, 日, 罒, 又	艹, 口, 一, 口, 丨, ㇇, ㇏
曼	日, No glyph available	日, 罒, 又	口, 一, 口, 丨, ㇇, ㇏
慢	忄, 曼	忄, 日, 罒, 又	丨, 八, 口, 一, 口, 丨, ㇇, ㇏
漫	氵, 曼	氵, 日, 罒, 又	⺀, ㇀, 口, 一, 口, 丨, ㇇, ㇏
谩	讠, 曼	讠, 日, 罒, 又	㇊, 丶, 口, 一, 口, 丨, ㇇, ㇏
芒	艹, 亡	艹, 匸, 丶	艹, 匸, 丶
茫	艹, 汒	艹, 氵, 匸, 丶	艹, ⺀, ㇀, 匸, 丶
盲	亡, 目	匸, 丶, 目	匸, 丶, 口, 二
氓	亡, 民	匸, 丶, 巳, ㇂, 一	匸, 丶, 丨, 匚, 乚, ㇂, 一
忙	忄, 亡	忄, 匸, 丶	丨, 八, 匸, 丶
莽	艹, No glyph available	艹, 犬, 艹	艹, 人, 一, 丶, 艹
猫	犭, 苗	犭, 艹, 田	㇁, ㇒, 艹, 冂, 一, 丨, 一
茅	艹, 矛	艹, 矛	艹, 龴, ㇖, 亅, ㇒
锚	钅, 苗	钅, 艹, 田	丿, 一, 乚, 二, 艹, 冂, 一, 丨, 一
毛	㇒, No glyph available	毛	㇒, 二, 乚
矛	龴, No glyph available	矛	龴, ㇖, 亅, ㇒
铆	钅, 卯	钅, 卯	丿, 一, 乚, 二, 卯
卯	卩	卯	卯
茂	艹, 戊	艹, 厂, 戈	艹, 厂, 戈
冒	冃, 目	冂, 二, 目	冂, 二, 口, 二
帽	巾, 冒	巾, 冂, 二, 目	冂, 丨, 冂, 二, 口, 二
貌	豸, 皃	豸, 白, 儿	爫, ㇁, ㇒, 口, 一, ㇒, 丿, 乚
贸	卯, 贝	卯, 贝	卯, 冂, 人
么	丿, 厶	丿, 厶	丿, ㇛, 丶
玫	王, ⺙	王, ⺙	一, 一, 丨, 一, 丿, 一, 乂
枚	木, ⺙	木, ⺙	一, 丨, 八, 丿, 一, 乂
梅	木, 每	木, 丿, 一, 母	一, 丨, 八, 丿, 一, ㇗, ㇆, ⺀, 一
酶	酉, 每	酉, 丿, 一, 母	一, 丿, 乚, 口, 一, 丿, 一, ㇗, ㇆, ⺀, 一
霉	雨, 每	雨, 丿, 一, 母	一, 冂, 丨, 丶, ㇀, 冫, 丿, 一, ㇗, ㇆, ⺀, 一
煤	火, 某	火, 甘, 木	丿, 丶, 冫, 艹, 二, 一, 丨, 八
没	氵, 殳	氵, 殳	⺀, ㇀, 丿, ㇠, ㇇, ㇏
眉	𠃜, 目	丨, No glyph availabl, 丨, 目	丨, 匚, 丨, 口, 二
媒	女, 某	女, 甘, 木	㇛, 一, 丿, 艹, 二, 一, 丨, 八
镁	钅, 美	钅, 羊, 大	丿, 一, 乚, 二, 一, 二, 丨, 丷, 人, 一
每	𠂉, 母	丿, 一, 母	丿, 一, ㇗, ㇆, ⺀, 一
美	羊, 大	羊, 大	一, 二, 丨, 丷, 人, 一
昧	日, 未	日, 木, 一	口, 一, 一, 丨, 八, 一
寐	宀, No glyph available	宀, 爿, 木, 一	冖, 丶, 爿, 一, 丨, 八, 一
妹	女, 未	女, 木, 一	㇛, 一, 丿, 一, 丨, 八, 一
媚	女, 眉	女, 丨, No glyph availabl, 丨, 目	㇛, 一, 丿, 丨, 匚, 丨, 口, 二
门	No glyph available, ㇆	门	丶, 丨, ㇆
闷	门, 心	门, 心	丶, 丨, ㇆, 𠁼, ㇃
们	亻, 门	亻, 门	㇒, 丨, 丶, 丨, ㇆
萌	艹, 明	艹, 日, 月	艹, 口, 一, 冂, 二
蒙	艹, 冡	艹, 冖, 二, 勹, No glyph availabl, No glyph availabl	艹, 冖, 二, ㇆, ㇒, ㇒, 冫
檬	木, 蒙	木, 艹, 冖, 二, 勹, No glyph availabl, No glyph availabl	一, 丨, 八, 艹, 冖, 二, ㇆, ㇒, ㇒, 冫
盟	明, 皿	日, 月, 皿	口, 一, 冂, 二, 冂, 丨, 一
锰	钅, 孟	钅, 子, 皿	丿, 一, 乚, 二, ㇇, 亅, 一, 冂, 丨, 一
猛	犭, 孟	犭, 子, 皿	㇁, ㇒, ㇇, 亅, 一, 冂, 丨, 一
梦	林, 夕	林, 夕	林, 夕
孟	子, 皿	子, 皿	㇇, 亅, 一, 冂, 丨, 一
眯	目, 米	目, 米	口, 二, 一, 丨, 八, 丷
醚	酉, 迷	酉, 辶, 米	一, 丿, 乚, 口, 一, 丶, ㇆, ㇝, 一, 丨, 八, 丷
靡	麻, 非	麻, 非	厂, 丶, 林, 非
糜	麻, 米	麻, 米	厂, 丶, 林, 一, 丨, 八, 丷
迷	辶, 米	辶, 米	丶, ㇆, ㇝, 一, 丨, 八, 丷
谜	讠, 迷	讠, 辶, 米	㇊, 丶, 丶, ㇆, ㇝, 一, 丨, 八, 丷
弥	弓, 尔	弓, ⺈, 小	匚, ㇉, ⺈, 亅, 八
米	木, 丷	米	一, 丨, 八, 丷
秘	禾, 必	禾, 心, 丿	㇒, 一, 丨, 八, 𠁼, ㇃, 丿
觅	爫, 见	爫, 见	爫, 冂, 丿, 乚
泌	氵, 必	氵, 心, 丿	⺀, ㇀, 𠁼, ㇃, 丿
蜜	宀, No glyph available	宀, 心, 丿, 虫	冖, 丶, 𠁼, ㇃, 丿, 口, 丨, 𠂉
密	宀, 𡶇	宀, 心, 丿, 山	冖, 丶, 𠁼, ㇃, 丿, 丨, 凵
幂	冖, No glyph available	冖, 日, 大, 巾	冖, 口, 一, 人, 一, 冂, 丨
棉	木, 帛	木, 白, 巾	一, 丨, 八, 口, 一, ㇒, 冂, 丨
眠	目, 民	目, 巳, ㇂, 一	口, 二, 丨, 匚, 乚, ㇂, 一
绵	纟, 帛	纟, 白, 巾	㇛, 一, 口, 一, ㇒, 冂, 丨
冕	冃, 免	冂, 二, ⺈, 口, 丨, 乚	冂, 二, ⺈, 口, 丨, 乚
免	⺈, No glyph available	⺈, 口, 丨, 乚	⺈, 口, 丨, 乚
勉	免, 力	⺈, 口, 丨, 乚, 力	⺈, 口, 丨, 乚, ㇆, 丿
娩	女, 免	女, ⺈, 口, 丨, 乚	㇛, 一, 丿, ⺈, 口, 丨, 乚
缅	纟, 面	纟, 面	㇛, 一, 一, 丿, 冂, 一, 丨, 二
面	丆, 囬	面	一, 丿, 冂, 一, 丨, 二
苗	艹, 田	艹, 田	艹, 冂, 一, 丨, 一
描	扌, 苗	扌, 艹, 田	亅, 二, 艹, 冂, 一, 丨, 一
瞄	目, 苗	目, 艹, 田	口, 二, 艹, 冂, 一, 丨, 一
藐	艹, 貌	艹, 豸, 白, 儿	艹, 爫, ㇁, ㇒, 口, 一, ㇒, 丿, 乚
秒	禾, 少	禾, 小, 丿	㇒, 一, 丨, 八, 亅, 八, 丿
渺	氵, 眇	氵, 目, 小, 丿	⺀, ㇀, 口, 二, 亅, 八, 丿
庙	广, 由	广, 二, 丨, 凵	厂, 丶, 二, 丨, 凵
妙	女, 少	女, 小, 丿	㇛, 一, 丿, 亅, 八, 丿
蔑	艹, No glyph available	艹, 罒, 厂, 戈, 丶	艹, 口, 丨, 厂, 戈, 丶
灭	一, 火	一, 火	一, 丿, 丶, 冫
民	巳, No glyph available	巳, ㇂, 一	丨, 匚, 乚, ㇂, 一
抿	扌, 民	扌, 巳, ㇂, 一	亅, 二, 丨, 匚, 乚, ㇂, 一
皿	𦉫, 一	皿	冂, 丨, 一
敏	每, ⺙	丿, 一, 母, ⺙	丿, 一, ㇗, ㇆, ⺀, 一, 丿, 一, 乂
悯	忄, 闵	忄, 门, 文	丨, 八, 丶, 丨, ㇆, 一, 丶, 乂
闽	门, 虫	门, 虫	丶, 丨, ㇆, 口, 丨, 𠂉
明	日, 月	日, 月	口, 一, 冂, 二
螟	虫, 冥	虫, 冖, 日, 亠, 八	口, 丨, 𠂉, 冖, 口, 一, 一, 丶, 八
鸣	口, 鸟	口, 鸟	口, ㇆, ㇉, 丶, 丶, 一
铭	钅, 名	钅, 夕, 口	丿, 一, 乚, 二, 夕, 口
名	夕, 口	夕, 口	夕, 口
命	亼, 叩	人, 一, 口, 卩	人, 一, 口, 丨, ㇆
谬	讠, 翏	讠, 羽, 人, 彡	㇊, 丶, 羽, 人, 彡
摸	扌, 莫	扌, 艹, 日, 大	亅, 二, 艹, 口, 一, 人, 一
摹	莫, 手	艹, 日, 大, 手	艹, 口, 一, 人, 一, ㇒, 亅, 二
蘑	艹, 磨	艹, 麻, 石	艹, 厂, 丶, 林, 一, 丿, 口
模	木, 莫	木, 艹, 日, 大	一, 丨, 八, 艹, 口, 一, 人, 一
膜	月, 莫	月, 艹, 日, 大	冂, 二, 艹, 口, 一, 人, 一
磨	麻, 石	麻, 石	厂, 丶, 林, 一, 丿, 口
摩	麻, 手	麻, 手	厂, 丶, 林, ㇒, 亅, 二
魔	麻, 鬼	麻, 鬼	厂, 丶, 林, 冂, 二, 丨, 丶, 乚, ㇛, 丶
抹	扌, 末	扌, 木, 一	亅, 二, 一, 丨, 八, 一
末	木, 一	木, 一	一, 丨, 八, 一
莫	艹, 旲	艹, 日, 大	艹, 口, 一, 人, 一
墨	黑, 土	黑, 土	口, 丨, 丷, 一, 丨, 一, 灬, 一, 丨, 一
默	黑, 犬	黑, 犬	口, 丨, 丷, 一, 丨, 一, 灬, 人, 一, 丶
沫	氵, 末	氵, 木, 一	⺀, ㇀, 一, 丨, 八, 一
漠	氵, 莫	氵, 艹, 日, 大	⺀, ㇀, 艹, 口, 一, 人, 一
寞	宀, 莫	宀, 艹, 日, 大	冖, 丶, 艹, 口, 一, 人, 一
陌	阝, 百	阝, 一, 白	丨, ㇌, 一, 口, 一, ㇒
谋	讠, 某	讠, 甘, 木	㇊, 丶, 艹, 二, 一, 丨, 八
牟	厶, 牛	厶, 牛	㇛, 丶, 二, 丨, ㇒
某	甘, 木	甘, 木	艹, 二, 一, 丨, 八
拇	扌, 母	扌, 母	亅, 二, ㇗, ㇆, ⺀, 一
牡	牛, 土	牛, 土	二, 丨, ㇒, 一, 丨, 一
亩	亠, 田	亠, 田	一, 丶, 冂, 一, 丨, 一
姆	女, 母	女, 母	㇛, 一, 丿, ㇗, ㇆, ⺀, 一
母	No glyph available, No glyph available	母	㇗, ㇆, ⺀, 一
墓	莫, 土	艹, 日, 大, 土	艹, 口, 一, 人, 一, 一, 丨, 一
暮	艹, No glyph available	艹, 日, 大, 日	艹, 口, 一, 人, 一, 口, 一
幕	艹, No glyph available	艹, 日, 大, 巾	艹, 口, 一, 人, 一, 冂, 丨
募	莫, 力	艹, 日, 大, 力	艹, 口, 一, 人, 一, ㇆, 丿
慕	莫, 㣺	艹, 日, 大, 丨, ㇒, No glyph availabl	艹, 口, 一, 人, 一, 丨, ㇒, ㇏
木	十, 八	木	一, 丨, 八
目	口, 二	目	口, 二
睦	目, 坴	目, 土, 八, 土	口, 二, 一, 丨, 一, 八, 一, 丨, 一
牧	牛, ⺙	牛, ⺙	二, 丨, ㇒, 丿, 一, 乂
穆	禾, 㣎	禾, 白, 小, 彡	㇒, 一, 丨, 八, 口, 一, ㇒, 亅, 八, 彡
拿	合, 手	人, 一, 口, 手	人, 一, 口, ㇒, 亅, 二
哪	口, 那	口, ㇆, 二, 丨, 阝	口, ㇆, 二, 丨, 丨, ㇌
呐	口, 内	口, 人, 冂	口, 人, 冂
钠	钅, 内	钅, 人, 冂	丿, 一, 乚, 二, 人, 冂
那	No glyph available, 阝	㇆, 二, 丨, 阝	㇆, 二, 丨, 丨, ㇌
娜	女, 那	女, ㇆, 二, 丨, 阝	㇛, 一, 丿, ㇆, 二, 丨, 丨, ㇌
纳	纟, 内	纟, 人, 冂	㇛, 一, 人, 冂
氖	气, 乃	气, ㇎, 丿	丿, 一, 一, ㇠, ㇎, 丿
乃	㇎, 丿	㇎, 丿	㇎, 丿
奶	女, 乃	女, ㇎, 丿	㇛, 一, 丿, ㇎, 丿
耐	而, 寸	而, 寸	一, 丿, 冂, 丨, 𠂇, 亅, 丶
奈	大, 示	大, 示	人, 一, 二, 亅, 八
南	十, No glyph available	十, 冂, 丷, 干	一, 丨, 冂, 丷, 一, 一, 丨
男	田, 力	田, 力	冂, 一, 丨, 一, ㇆, 丿
难	又, 隹	又, 隹	㇇, ㇏, ㇒, 丨, 一, 二, 丨, 一, 丶
囊	No glyph available, No glyph available	十, 口, 丨, 冖, 吅, No glyph availabl, 二, 一, ㇒, ㇗, No glyph availabl	一, 丨, 口, 丨, 冖, 吅, 丨, 二, 一, ㇒, ㇗, 冫
挠	扌, 尧	扌, No glyph availabl, 一, 儿	亅, 二, ㇂, 一, ㇒, 一, 丿, 乚
脑	月, No glyph available	月, 亠, 凵, 乂	冂, 二, 一, 丶, 凵, 乂
恼	忄, No glyph available	忄, 亠, 凵, 乂	丨, 八, 一, 丶, 凵, 乂
闹	门, 市	门, 亠, 巾	丶, 丨, ㇆, 一, 丶, 冂, 丨
淖	氵, 卓	氵, ⺊, 日, 十	⺀, ㇀, 丨, 一, 口, 一, 一, 丨
呢	口, 尼	口, 尸, 匕	口, 丨, 匚, 乚, ㇒
馁	饣, 妥	饣, 爫, 女	⺈, 乚, 爫, ㇛, 一, 丿
内	人, 冂	人, 冂	人, 冂
嫩	女, 敕	女, 木, 口, ⺙	㇛, 一, 丿, 一, 丨, 八, 口, 丿, 一, 乂
能	䏍, No glyph available	厶, 月, No glyph availabl	㇛, 丶, 冂, 二, 匕
妮	女, 尼	女, 尸, 匕	㇛, 一, 丿, 丨, 匚, 乚, ㇒
霓	雨, 兒	雨, 臼, 儿	一, 冂, 丨, 丶, ㇀, 冫, 臼, 丿, 乚
倪	亻, 兒	亻, 臼, 儿	㇒, 丨, 臼, 丿, 乚
泥	氵, 尼	氵, 尸, 匕	⺀, ㇀, 丨, 匚, 乚, ㇒
尼	尸, 匕	尸, 匕	丨, 匚, 乚, ㇒
拟	扌, 以	扌, 乚, 丶, 人	亅, 二, 乚, 丶, 人
你	亻, 尔	亻, ⺈, 小	㇒, 丨, ⺈, 亅, 八
匿	匚, 若	匚, 艹, 𠂇, 口	一, ㇗, 艹, 𠂇, 口
腻	月, 贰	月, 弋, 二, 贝	冂, 二, 弋, 二, 冂, 人
逆	辶, 屰	辶, 丷, 一, 屮	丶, ㇆, ㇝, 丷, 一, 丨, 凵
溺	氵, 弱	氵, 弱	⺀, ㇀, 弱
蔫	艹, 焉	艹, 一, 止, No glyph availabl, 灬	艹, 一, 丨, 一, 丨, 一, 己, 灬
拈	扌, 占	扌, ⺊, 口	亅, 二, 丨, 一, 口
年	𠂉, 㐄	丿, 一, 十, ㇗, 丨	丿, 一, 一, 丨, ㇗, 丨
碾	石, 展	石, 尸, 艹, 一, 乚, No glyph availabl	一, 丿, 口, 丨, 匚, 艹, 一, 乚, 冫
撵	扌, 辇	扌, 㚘, 车	亅, 二, 㚘, 乚, 一, 一, 丨
捻	扌, 念	扌, 人, 丶, ㇇, 心	亅, 二, 人, 丶, ㇇, 𠁼, ㇃
念	今, 心	人, 丶, ㇇, 心	人, 丶, ㇇, 𠁼, ㇃
娘	女, 良	女, 艮, 丶	㇛, 一, 丿, 丨, ㇕, 二, 乚, 冫, 丶
酿	酉, 良	酉, 艮, 丶	一, 丿, 乚, 口, 一, 丨, ㇕, 二, 乚, 冫, 丶
鸟	No glyph available, 一	鸟	㇆, ㇉, 丶, 丶, 一
尿	尸, 水	尸, 水	丨, 匚, 亅, ㇇, 冫
捏	扌, 圼	扌, 日, 土	亅, 二, 口, 一, 一, 丨, 一
聂	耳, 双	耳, 双	二, 丨, 二, 双
孽	薛, 子	艹, 㠯, 丶, 辛, 子	艹, 㠯, 丶, 一, 丶, 丷, 一, 一, 丨, ㇇, 亅, 一
啮	口, 齿	口, 齿	口, 丨, 一, 丨, 一, 凵, 人
镊	钅, 聂	钅, 耳, 双	丿, 一, 乚, 二, 二, 丨, 二, 双
镍	钅, 臬	钅, 自, 木	丿, 一, 乚, 二, 口, 二, 丶, 一, 丨, 八
涅	氵, 圼	氵, 日, 土	⺀, ㇀, 口, 一, 一, 丨, 一
您	你, 心	亻, ⺈, 小, 心	㇒, 丨, ⺈, 亅, 八, 𠁼, ㇃
柠	木, 宁	木, 宀, 一, 亅	一, 丨, 八, 冖, 丶, 一, 亅
狞	犭, 宁	犭, 宀, 一, 亅	㇁, ㇒, 冖, 丶, 一, 亅
凝	冫, 疑	冫, 匕, 矢, 龴, 疋	丶, ㇀, 乚, ㇒, 丿, 一, 人, 一, 龴, ㇖, 龰
宁	宀, 丁	宀, 一, 亅	冖, 丶, 一, 亅
拧	扌, 宁	扌, 宀, 一, 亅	亅, 二, 冖, 丶, 一, 亅
泞	氵, 宁	氵, 宀, 一, 亅	⺀, ㇀, 冖, 丶, 一, 亅
牛	No glyph available, ㇒	牛	二, 丨, ㇒
扭	扌, 丑	扌, 刀, 二	亅, 二, ㇆, 丿, 二
钮	钅, 丑	钅, 刀, 二	丿, 一, 乚, 二, ㇆, 丿, 二
纽	纟, 丑	纟, 刀, 二	㇛, 一, ㇆, 丿, 二
脓	月, 农	月, 巾, ㇒, ㇗, No glyph availabl	冂, 二, 冂, 丨, ㇒, ㇗, 冫
浓	氵, 农	氵, 巾, ㇒, ㇗, No glyph availabl	⺀, ㇀, 冂, 丨, ㇒, ㇗, 冫
农	巾, 𧘇	巾, ㇒, ㇗, No glyph availabl	冂, 丨, ㇒, ㇗, 冫
弄	王, 艹	王, 艹	一, 一, 丨, 一, 艹
奴	女, 又	女, 又	㇛, 一, 丿, ㇇, ㇏
努	奴, 力	女, 又, 力	㇛, 一, 丿, ㇇, ㇏, ㇆, 丿
怒	奴, 心	女, 又, 心	㇛, 一, 丿, ㇇, ㇏, 𠁼, ㇃
女	㇛, 丆	女	㇛, 一, 丿
暖	日, 爰	日, 爫, 干, 又	口, 一, 爫, 一, 一, 丨, ㇇, ㇏
虐	虍, No glyph available	虍, No glyph availabl	丨, 一, 冖, 乚, 一, ⺕
疟	疒, No glyph available	疒, No glyph availabl	一, 丶, 厂, 丶, ⺕
挪	扌, 那	扌, ㇆, 二, 丨, 阝	亅, 二, ㇆, 二, 丨, 丨, ㇌
懦	忄, 需	忄, 雨, 而	丨, 八, 一, 冂, 丨, 丶, ㇀, 冫, 一, 丿, 冂, 丨
糯	米, 需	米, 雨, 而	一, 丨, 八, 丷, 一, 冂, 丨, 丶, ㇀, 冫, 一, 丿, 冂, 丨
诺	讠, 若	讠, 艹, 𠂇, 口	㇊, 丶, 艹, 𠂇, 口
哦	口, 我	口, 手, 戈	口, ㇒, 亅, 二, 戈
欧	区, 欠	匚, 乂, 欠	一, ㇗, 乂, ⺈, 人
鸥	区, 鸟	匚, 乂, 鸟	一, ㇗, 乂, ㇆, ㇉, 丶, 丶, 一
殴	区, 殳	匚, 乂, 殳	一, ㇗, 乂, 丿, ㇠, ㇇, ㇏
藕	艹, 耦	艹, 耒, 冂, 二, 丨, 禸	艹, 一, 二, 丨, 八, 冂, 二, 丨, ㇛, 丶, 冂
呕	口, 区	口, 匚, 乂	口, 一, ㇗, 乂
偶	亻, 禺	亻, 冂, 二, 丨, 禸	㇒, 丨, 冂, 二, 丨, ㇛, 丶, 冂
沤	氵, 区	氵, 匚, 乂	⺀, ㇀, 一, ㇗, 乂
啪	口, 拍	口, 扌, 白	口, 亅, 二, 口, 一, ㇒
趴	⻊, 八	⻊, 八	口, 丨, 一, 丨, 一, 八
爬	爪, 巴	爪, 丨, No glyph availabl, 丨, 乚	丿, ㇒, ㇏, 丨, 丨, 匚, 丨, 乚
帕	巾, 白	巾, 白	冂, 丨, 口, 一, ㇒
怕	忄, 白	忄, 白	丨, 八, 口, 一, ㇒
琶	玨, 巴	玨, 丨, No glyph availabl, 丨, 乚	玨, 丨, 匚, 丨, 乚
拍	扌, 白	扌, 白	亅, 二, 口, 一, ㇒
排	扌, 非	扌, 非	亅, 二, 非
牌	片, 卑	片, 冂, 二, 丨, 丶, 十	丨, 丨, 一, ㇕, 冂, 二, 丨, 丶, 一, 丨
徘	彳, 非	彳, 非	㇒, 丨, 非
湃	氵, 拜	氵, 龵, 一, 一, 二, 丨	⺀, ㇀, 龵, 一, 一, 二, 丨
派	氵, No glyph available	氵, ⺁, 匚, No glyph availabl	⺀, ㇀, 丿, ㇒, 一, ㇗, 冫
攀	棥, No glyph available	林, 爻, 大, 手	林, 爻, 人, 一, ㇒, 亅, 二
潘	氵, 番	氵, 釆, 田	⺀, ㇀, ㇒, 一, 丨, 八, 丷, 冂, 一, 丨, 一
盘	舟, 皿	舟, 皿	冂, 丶, ⺀, 一, 冂, 丨, 一
磐	般, 石	舟, 殳, 石	冂, 丶, ⺀, 一, 丿, ㇠, ㇇, ㇏, 一, 丿, 口
盼	目, 分	目, 八, 刀	口, 二, 八, ㇆, 丿
畔	田, 半	田, 二, 丨, 丷	冂, 一, 丨, 一, 二, 丨, 丷
判	半, 刂	二, 丨, 丷, 刂	二, 丨, 丷, 亅, 丨
叛	半, 反	二, 丨, 丷, ⺁, 又	二, 丨, 丷, 丿, ㇒, ㇇, ㇏
乓	丘, 丶	斤, 一, 丶	丿, ㇒, 一, 丨, 一, 丶
庞	广, 龙	广, 龙	厂, 丶, 𠂇, 丶, 乚, ㇒
旁	No glyph available, 方	亠, 丷, 冖, 方	一, 丶, 丷, 冖, 一, 丶, 丿, ㇆
耪	耒, 旁	耒, 亠, 丷, 冖, 方	一, 二, 丨, 八, 一, 丶, 丷, 冖, 一, 丶, 丿, ㇆
胖	月, 半	月, 二, 丨, 丷	冂, 二, 二, 丨, 丷
抛	扌, 𠠵	扌, 丿, ㇈, 力	亅, 二, 丿, ㇈, ㇆, 丿
咆	口, 包	口, 勹, 巳	口, ㇆, ㇒, 丨, 匚, 乚
刨	包, 刂	勹, 巳, 刂	㇆, ㇒, 丨, 匚, 乚, 亅, 丨
炮	火, 包	火, 勹, 巳	丿, 丶, 冫, ㇆, ㇒, 丨, 匚, 乚
袍	衤, 包	衤, 勹, 巳	一, 一, 丨, 一, 丶, 戈, 丨, 冫, ㇆, ㇒, 丨, 匚, 乚
跑	⻊, 包	⻊, 勹, 巳	口, 丨, 一, 丨, 一, ㇆, ㇒, 丨, 匚, 乚
泡	氵, 包	氵, 勹, 巳	⺀, ㇀, ㇆, ㇒, 丨, 匚, 乚
呸	口, 丕	口, 一, 丿, 卜, 一	口, 一, 丿, 丨, 丶, 一
胚	月, 丕	月, 一, 丿, 卜, 一	冂, 二, 一, 丿, 丨, 丶, 一
培	土, 咅	土, 立, 口	一, 丨, 一, 一, 丶, 丷, 一, 口
裴	非, 衣	非, 衣	非, 一, 丶, ㇒, ㇗, 冫
赔	贝, 咅	贝, 立, 口	冂, 人, 一, 丶, 丷, 一, 口
陪	阝, 咅	阝, 立, 口	丨, ㇌, 一, 丶, 丷, 一, 口
配	酉, 己	酉, 己	一, 丿, 乚, 口, 一, 匚, 乚
佩	亻, No glyph available	亻, 几, 一, 巾	㇒, 丨, 丿, ㇠, 一, 冂, 丨
沛	氵, 巿	氵, 十, 巾	⺀, ㇀, 一, 丨, 冂, 丨
喷	口, 贲	口, 十, 艹, 贝	口, 一, 丨, 艹, 冂, 人
盆	分, 皿	八, 刀, 皿	八, ㇆, 丿, 冂, 丨, 一
砰	石, 平	石, 干, 丷	一, 丿, 口, 一, 一, 丨, 丷
抨	扌, 平	扌, 干, 丷	亅, 二, 一, 一, 丨, 丷
烹	No glyph available, No glyph available	亠, 口, ㇇, 亅, 灬	一, 丶, 口, ㇇, 亅, 灬
澎	氵, 彭	氵, 十, 豆, 彡	⺀, ㇀, 一, 丨, 一, 口, 丷, 一, 彡
彭	壴, 彡	十, 豆, 彡	一, 丨, 一, 口, 丷, 一, 彡
蓬	艹, 逢	艹, 辶, 夂, 一, 二, 丨	艹, 丶, ㇆, ㇝, ㇇, ㇏, ㇒, 一, 二, 丨
棚	木, 朋	木, 朋	一, 丨, 八, 朋
硼	石, 朋	石, 朋	一, 丿, 口, 朋
篷	⺮, 逢	⺮, 辶, 夂, 一, 二, 丨	⺮, 丶, ㇆, ㇝, ㇇, ㇏, ㇒, 一, 二, 丨
膨	月, 彭	月, 十, 豆, 彡	冂, 二, 一, 丨, 一, 口, 丷, 一, 彡
朋	月	朋	朋
鹏	朋, 鸟	朋, 鸟	朋, ㇆, ㇉, 丶, 丶, 一
捧	扌, 奉	扌, 一, 二, 丨, 八, 二, 丨	亅, 二, 一, 二, 丨, 八, 二, 丨
碰	石, 並	石, 丷, 一, No glyph availabl, 丷, 一	一, 丿, 口, 丷, 一, 丨, 丷, 一
坯	土, 丕	土, 一, 丿, 卜, 一	一, 丨, 一, 一, 丿, 丨, 丶, 一
砒	石, 比	石, 比	一, 丿, 口, 比
霹	雨, 辟	雨, 尸, 口, 辛	一, 冂, 丨, 丶, ㇀, 冫, 丨, 匚, 口, 一, 丶, 丷, 一, 一, 丨
批	扌, 比	扌, 比	亅, 二, 比
披	扌, 皮	扌, 皮	亅, 二, 丿, ㇆, 丨, ㇇, ㇏
劈	辟, 刀	尸, 口, 辛, 刀	丨, 匚, 口, 一, 丶, 丷, 一, 一, 丨, ㇆, 丿
琵	玨, 比	玨, 比	玨, 比
毗	田, 比	田, 比	冂, 一, 丨, 一, 比
啤	口, 卑	口, 冂, 二, 丨, 丶, 十	口, 冂, 二, 丨, 丶, 一, 丨
脾	月, 卑	月, 冂, 二, 丨, 丶, 十	冂, 二, 冂, 二, 丨, 丶, 一, 丨
疲	疒, 皮	疒, 皮	一, 丶, 厂, 丶, 丿, ㇆, 丨, ㇇, ㇏
皮	No glyph available, 又	皮	丿, ㇆, 丨, ㇇, ㇏
匹	匚, 儿	匚, 儿	一, ㇗, 丿, 乚
痞	疒, 否	疒, 一, 丿, 卜, 口	一, 丶, 厂, 丶, 一, 丿, 丨, 丶, 口
僻	亻, 辟	亻, 尸, 口, 辛	㇒, 丨, 丨, 匚, 口, 一, 丶, 丷, 一, 一, 丨
屁	尸, 比	尸, 比	丨, 匚, 比
譬	辟, 言	尸, 口, 辛, 言	丨, 匚, 口, 一, 丶, 丷, 一, 一, 丨, 一, 丶, 二, 口
篇	⺮, 扁	⺮, 户, 冂, 艹	⺮, 丨, 匚, 丶, 冂, 艹
偏	亻, 扁	亻, 户, 冂, 艹	㇒, 丨, 丨, 匚, 丶, 冂, 艹
片	No glyph available, ㇕	片	丨, 丨, 一, ㇕
骗	马, 扁	马, 户, 冂, 艹	㇕, ㇉, 一, 丨, 匚, 丶, 冂, 艹
飘	票, 风	覀, 示, 风	覀, 二, 亅, 八, 丿, ㇠, 乂
漂	氵, 票	氵, 覀, 示	⺀, ㇀, 覀, 二, 亅, 八
瓢	票, 瓜	覀, 示, 瓜	覀, 二, 亅, 八, 丿, ㇒, ㇏, ㇛, 丶
票	覀, 示	覀, 示	覀, 二, 亅, 八
撇	扌, 敝	扌, 巾, 冫, No glyph availabl, ⺙	亅, 二, 冂, 丨, 丶, ㇀, 冫, 丿, 一, 乂
瞥	敝, 目	巾, 冫, No glyph availabl, ⺙, 目	冂, 丨, 丶, ㇀, 冫, 丿, 一, 乂, 口, 二
拼	扌, 并	扌, 丷, 一, 廾	亅, 二, 丷, 一, 廾
频	步, 页	止, 小, 丿, 页	丨, 一, 丨, 一, 亅, 八, 丿, 一, 丿, 冂, 人
贫	分, 贝	八, 刀, 贝	八, ㇆, 丿, 冂, 人
品	口	品	品
聘	耳, 甹	耳, 二, 丨, 凵, 一, ㇉	二, 丨, 二, 二, 丨, 凵, 一, ㇉
乒	丘, 丿	斤, 一, 丿	丿, ㇒, 一, 丨, 一, 丿
坪	土, 平	土, 干, 丷	一, 丨, 一, 一, 一, 丨, 丷
苹	艹, 平	艹, 干, 丷	艹, 一, 一, 丨, 丷
萍	艹, 泙	艹, 氵, 干, 丷	艹, ⺀, ㇀, 一, 一, 丨, 丷
平	干, 丷	干, 丷	一, 一, 丨, 丷
凭	任, 几	亻, ㇒, 士, 几	㇒, 丨, ㇒, 一, 丨, 一, 丿, ㇠
瓶	并, 瓦	丷, 一, 廾, 瓦	丷, 一, 廾, 匸, ㇈, 丶
评	讠, 平	讠, 干, 丷	㇊, 丶, 一, 一, 丨, 丷
屏	尸, 并	尸, 丷, 一, 廾	丨, 匚, 丷, 一, 廾
坡	土, 皮	土, 皮	一, 丨, 一, 丿, ㇆, 丨, ㇇, ㇏
泼	氵, 发	氵, ㇗, 丨, 丶, 又	⺀, ㇀, ㇗, 丨, 丶, ㇇, ㇏
颇	皮, 页	皮, 页	丿, ㇆, 丨, ㇇, ㇏, 一, 丿, 冂, 人
婆	波, 女	氵, 皮, 女	⺀, ㇀, 丿, ㇆, 丨, ㇇, ㇏, ㇛, 一, 丿
破	石, 皮	石, 皮	一, 丿, 口, 丿, ㇆, 丨, ㇇, ㇏
魄	白, 鬼	白, 鬼	口, 一, ㇒, 冂, 二, 丨, 丶, 乚, ㇛, 丶
迫	辶, 白	辶, 白	丶, ㇆, ㇝, 口, 一, ㇒
粕	米, 白	米, 白	一, 丨, 八, 丷, 口, 一, ㇒
剖	咅, 刂	立, 口, 刂	一, 丶, 丷, 一, 口, 亅, 丨
扑	扌, 卜	扌, 卜	亅, 二, 丨, 丶
铺	钅, 甫	钅, 十, 用, 丶	丿, 一, 乚, 二, 一, 丨, 冂, 二, 丨, 丶
仆	亻, 卜	亻, 卜	㇒, 丨, 丨, 丶
莆	艹, 甫	艹, 十, 用, 丶	艹, 一, 丨, 冂, 二, 丨, 丶
葡	艹, 匍	艹, 勹, 十, 用, 丶	艹, ㇆, ㇒, 一, 丨, 冂, 二, 丨, 丶
菩	艹, 咅	艹, 立, 口	艹, 一, 丶, 丷, 一, 口
蒲	艹, 浦	艹, 氵, 十, 用, 丶	艹, ⺀, ㇀, 一, 丨, 冂, 二, 丨, 丶
埔	土, 甫	土, 十, 用, 丶	一, 丨, 一, 一, 丨, 冂, 二, 丨, 丶
朴	木, 卜	木, 卜	一, 丨, 八, 丨, 丶
圃	囗, 甫	囗, 十, 用, 丶	冂, 一, 一, 丨, 冂, 二, 丨, 丶
普	並, 日	丷, 一, No glyph availabl, 丷, 一, 日	丷, 一, 丨, 丷, 一, 口, 一
浦	氵, 甫	氵, 十, 用, 丶	⺀, ㇀, 一, 丨, 冂, 二, 丨, 丶
谱	讠, 普	讠, 丷, 一, No glyph availabl, 丷, 一, 日	㇊, 丶, 丷, 一, 丨, 丷, 一, 口, 一
曝	日, No glyph available	日, 日, 艹, 一, 八, 氺	口, 一, 口, 一, 艹, 一, 八, 亅, 丶, ㇀, 冫
瀑	氵, 暴	氵, 日, 艹, 一, 八, 水	⺀, ㇀, 口, 一, 艹, 一, 八, 亅, ㇇, 冫
期	其, 月	甘, 一, 八, 月	艹, 二, 一, 八, 冂, 二
欺	其, 欠	甘, 一, 八, 欠	艹, 二, 一, 八, ⺈, 人
栖	木, 西	木, 西	一, 丨, 八, 一, 丿, 乚, 冂, 一
戚	戊, 尗	厂, 戈, ⺊, 一, 小	厂, 戈, 丨, 一, 一, 亅, 八
妻	No glyph available, 女	十, ⺺, 女	一, 丨, 匚, 一, 丨, ㇛, 一, 丿
七	乚, 一	乚, 一	乚, 一
凄	冫, 妻	冫, 十, ⺺, 女	丶, ㇀, 一, 丨, 匚, 一, 丨, ㇛, 一, 丿
漆	氵, 桼	氵, 木, 人, 氺	⺀, ㇀, 一, 丨, 八, 人, 亅, 丶, ㇀, 冫
柒	No glyph available, 木	氵, 乚, 一, 木	⺀, ㇀, 乚, 一, 一, 丨, 八
沏	氵, 切	氵, 乚, 一, 刀	⺀, ㇀, 乚, 一, ㇆, 丿
其	甘, No glyph available	甘, 一, 八	艹, 二, 一, 八
棋	木, 其	木, 甘, 一, 八	一, 丨, 八, 艹, 二, 一, 八
奇	大, 可	大, 一, 亅, 口	人, 一, 一, 亅, 口
歧	止, 支	止, 支	丨, 一, 丨, 一, 一, 丨, ㇇, ㇏
畦	田, 圭	田, 圭	冂, 一, 丨, 一, 圭
崎	山, 奇	山, 大, 一, 亅, 口	丨, 凵, 人, 一, 一, 亅, 口
脐	月, 齐	月, 齐	冂, 二, 一, 丶, 乂, 丨
齐	文, No glyph available	齐	一, 丶, 乂, 丨
旗	方, No glyph available	方, 丿, 一, 甘, 一, 八	一, 丶, 丿, ㇆, 丿, 一, 艹, 二, 一, 八
祈	礻, 斤	礻, 斤	一, 一, 丨, 一, 丶, 戈, 丨, 丶, 丿, ㇒, 一, 丨
祁	礻, 阝	礻, 阝	一, 一, 丨, 一, 丶, 戈, 丨, 丶, 丨, ㇌
骑	马, 奇	马, 大, 一, 亅, 口	㇕, ㇉, 一, 人, 一, 一, 亅, 口
起	走, 己	走, 己	一, 丨, 一, 龰, 匚, 乚
岂	山, 己	山, 己	丨, 凵, 匚, 乚
乞	𠂉, ㇠	丿, 一, ㇠	丿, 一, ㇠
企	人, 止	人, 止	人, 丨, 一, 丨, 一
启	户, 口	户, 口	丨, 匚, 丶, 口
契	㓞, 大	一, 二, 丨, 刀, 大	一, 二, 丨, ㇆, 丿, 人, 一
砌	石, 切	石, 乚, 一, 刀	一, 丿, 口, 乚, 一, ㇆, 丿
器	㗊, 犬	㗊, 犬	㗊, 人, 一, 丶
气	No glyph available, ㇠	气	丿, 一, 一, ㇠
迄	辶, 乞	辶, 丿, 一, ㇠	丶, ㇆, ㇝, 丿, 一, ㇠
弃	No glyph available, 艹	亠, 厶, 艹	一, 丶, ㇛, 丶, 艹
汽	氵, 气	氵, 气	⺀, ㇀, 丿, 一, 一, ㇠
泣	氵, 立	氵, 立	⺀, ㇀, 一, 丶, 丷, 一
讫	讠, 乞	讠, 丿, 一, ㇠	㇊, 丶, 丿, 一, ㇠
掐	扌, 臽	扌, ⺈, 臼	亅, 二, ⺈, 臼
洽	氵, 合	氵, 人, 一, 口	⺀, ㇀, 人, 一, 口
牵	大, No glyph available	大, 冖, 牛	人, 一, 冖, 二, 丨, ㇒
扦	扌, 千	扌, ㇒, 十	亅, 二, ㇒, 一, 丨
钎	钅, 千	钅, ㇒, 十	丿, 一, 乚, 二, ㇒, 一, 丨
铅	钅, No glyph available	钅, 几, 口	丿, 一, 乚, 二, 丿, ㇠, 口
千	㇒, 十	㇒, 十	㇒, 一, 丨
迁	辶, 千	辶, ㇒, 十	丶, ㇆, ㇝, ㇒, 一, 丨
签	⺮, 佥	⺮, 人, 一, ⺍, 一	⺮, 人, 一, ⺍, 一
仟	亻, 千	亻, ㇒, 十	㇒, 丨, ㇒, 一, 丨
谦	讠, 兼	讠, 丷, 一, No glyph availabl, 八, ⺕	㇊, 丶, 丷, 一, 丨, 八, 匚, 一
乾	龺, 乞	十, 日, 十, 丿, 一, ㇠	一, 丨, 口, 一, 一, 丨, 丿, 一, ㇠
黔	黑, 今	黑, 人, 丶, ㇇	口, 丨, 丷, 一, 丨, 一, 灬, 人, 丶, ㇇
钱	钅, 戋	钅, 戋	丿, 一, 乚, 二, 戋
钳	钅, 甘	钅, 甘	丿, 一, 乚, 二, 艹, 二
前	䒑, 刖	丷, 一, 月, 刂	丷, 一, 冂, 二, 亅, 丨
潜	氵, 替	氵, 㚘, 日	⺀, ㇀, 㚘, 口, 一
遣	辶, 𠳋	辶, 口, 丨, 一, 㠯	丶, ㇆, ㇝, 口, 丨, 一, 㠯
浅	氵, 戋	氵, 戋	⺀, ㇀, 戋
谴	讠, 遣	讠, 辶, 口, 丨, 一, 㠯	㇊, 丶, 丶, ㇆, ㇝, 口, 丨, 一, 㠯
堑	斩, 土	车, 斤, 土	乚, 一, 一, 丨, 丿, ㇒, 一, 丨, 一, 丨, 一
嵌	山, 𣢟	山, 甘, 欠	丨, 凵, 艹, 二, ⺈, 人
欠	⺈, 人	欠	⺈, 人
歉	兼, 欠	丷, 一, No glyph availabl, 八, ⺕, 欠	丷, 一, 丨, 八, 匚, 一, ⺈, 人
枪	木, 仓	木, 人, 乚, ㇆	一, 丨, 八, 人, 乚, ㇆
呛	口, 仓	口, 人, 乚, ㇆	口, 人, 乚, ㇆
腔	月, 空	月, 穴, 工	冂, 二, 冖, 丶, 八, 一, 丨, 一
羌	羊, 乚	羊, 乚	一, 二, 丨, 丷, 乚
墙	土, 啬	土, 土, 丷, 回	一, 丨, 一, 一, 丨, 一, 丷, 回
蔷	艹, 啬	艹, 土, 丷, 回	艹, 一, 丨, 一, 丷, 回
强	弓, 虽	弓, 口, 虫	匚, ㇉, 口, 口, 丨, 𠂉
抢	扌, 仓	扌, 人, 乚, ㇆	亅, 二, 人, 乚, ㇆
橇	木, 毳	木, 毳	一, 丨, 八, 毳
锹	钅, 秋	钅, 禾, 火	丿, 一, 乚, 二, ㇒, 一, 丨, 八, 丿, 丶, 冫
敲	高, 攴	高, 攴	一, 丶, 口, 冂, 口, 丨, 一, ㇇, ㇏
悄	忄, 肖	忄, ⺌, 月	丨, 八, 丨, 丷, 冂, 二
桥	木, 乔	木, ㇒, 大, No glyph availabl	一, 丨, 八, ㇒, 人, 一, 丨
瞧	目, 焦	目, 隹, 灬	口, 二, ㇒, 丨, 一, 二, 丨, 一, 丶, 灬
乔	夭, No glyph available	㇒, 大, No glyph availabl	㇒, 人, 一, 丨
侨	亻, 乔	亻, ㇒, 大, No glyph availabl	㇒, 丨, ㇒, 人, 一, 丨
巧	工, 丂	工, 一, ㇉	一, 丨, 一, 一, ㇉
鞘	革, 肖	革, ⺌, 月	卄, 一, 口, 丨, 一, 丨, 丨, 丷, 冂, 二
撬	扌, 毳	扌, 毳	亅, 二, 毳
翘	尧, 羽	No glyph availabl, 一, 儿, 羽	㇂, 一, ㇒, 一, 丿, 乚, 羽
峭	山, 肖	山, ⺌, 月	丨, 凵, 丨, 丷, 冂, 二
俏	亻, 肖	亻, ⺌, 月	㇒, 丨, 丨, 丷, 冂, 二
窍	穴, 巧	穴, 工, 一, ㇉	冖, 丶, 八, 一, 丨, 一, 一, ㇉
切	七, 刀	乚, 一, 刀	乚, 一, ㇆, 丿
茄	艹, 加	艹, 力, 口	艹, ㇆, 丿, 口
且	月, 一	月, 一	冂, 二, 一
怯	忄, 去	忄, 土, 厶	丨, 八, 一, 丨, 一, ㇛, 丶
窃	穴, 切	穴, 乚, 一, 刀	冖, 丶, 八, 乚, 一, ㇆, 丿
钦	钅, 欠	钅, 欠	丿, 一, 乚, 二, ⺈, 人
侵	亻, No glyph available	亻, 彐, 冖, 又	㇒, 丨, ㇕, 二, 冖, ㇇, ㇏
亲	立, 朩	立, 十, 小	一, 丶, 丷, 一, 一, 丨, 亅, 八
秦	𡗗, 禾	一, 二, 丨, 八, 禾	一, 二, 丨, 八, ㇒, 一, 丨, 八
琴	玨, 今	玨, 人, 丶, ㇇	玨, 人, 丶, ㇇
勤	堇, 力	廿, 口, 丨, 王, 力	卄, 一, 口, 丨, 一, 一, 丨, 一, ㇆, 丿
芹	艹, 斤	艹, 斤	艹, 丿, ㇒, 一, 丨
擒	扌, 禽	扌, 人, 亠, 凵, 乂, 禸	亅, 二, 人, 一, 丶, 凵, 乂, ㇛, 丶, 冂
禽	人, 离	人, 亠, 凵, 乂, 禸	人, 一, 丶, 凵, 乂, ㇛, 丶, 冂
寝	宀, No glyph available	宀, 丬, 彐, 冖, 又	冖, 丶, 一, 丶, 丨, ㇕, 二, 冖, ㇇, ㇏
沁	氵, 心	氵, 心	⺀, ㇀, 𠁼, ㇃
青	龶, 月	青	龶, 冂, 二
轻	车, No glyph available	车, 龴, 工	乚, 一, 一, 丨, 龴, 一, 丨, 一
氢	气, No glyph available	气, 龴, 工	丿, 一, 一, ㇠, 龴, 一, 丨, 一
倾	亻, 顷	亻, 匕, 页	㇒, 丨, 乚, ㇒, 一, 丿, 冂, 人
卿	卯, No glyph available	卯, 丨, 彐, 乚, 丶	卯, 丨, ㇕, 二, 乚, 丶
清	氵, 青	氵, 青	⺀, ㇀, 龶, 冂, 二
擎	敬, 手	艹, 勹, 口, ⺙, 手	艹, ㇆, ㇒, 口, 丿, 一, 乂, ㇒, 亅, 二
晴	日, 青	日, 青	口, 一, 龶, 冂, 二
氰	气, 青	气, 青	丿, 一, 一, ㇠, 龶, 冂, 二
情	忄, 青	忄, 青	丨, 八, 龶, 冂, 二
顷	匕, 页	匕, 页	乚, ㇒, 一, 丿, 冂, 人
请	讠, 青	讠, 青	㇊, 丶, 龶, 冂, 二
庆	广, 大	广, 大	厂, 丶, 人, 一
琼	王, 京	王, 亠, 口, 小	一, 一, 丨, 一, 一, 丶, 口, 亅, 八
穷	穴, 力	穴, 力	冖, 丶, 八, ㇆, 丿
秋	禾, 火	禾, 火	㇒, 一, 丨, 八, 丿, 丶, 冫
丘	斤, 一	斤, 一	丿, ㇒, 一, 丨, 一
邱	丘, 阝	斤, 一, 阝	丿, ㇒, 一, 丨, 一, 丨, ㇌
球	王, 求	王, 𠂇, 丶, 氺	一, 一, 丨, 一, 𠂇, 丶, 亅, 丶, ㇀, 冫
求	No glyph available, 氺	𠂇, 丶, 氺	𠂇, 丶, 亅, 丶, ㇀, 冫
囚	囗, 人	囗, 人	冂, 一, 人
酋	丷, 酉	丷, 酉	丷, 一, 丿, 乚, 口, 一
泅	氵, 囚	氵, 囗, 人	⺀, ㇀, 冂, 一, 人
趋	走, 刍	走, ⺈, 彐	一, 丨, 一, 龰, ⺈, ㇕, 二
区	匚, 乂	匚, 乂	一, ㇗, 乂
蛆	虫, 且	虫, 月, 一	口, 丨, 𠂉, 冂, 二, 一
曲	井, 凵	No glyph availabl, 二, 凵	丨, 二, 凵
躯	身, 区	身, 匚, 乂	𠂎, 丶, 二, 丿, 一, ㇗, 乂
屈	尸, 出	尸, 出	丨, 匚, 出
驱	马, 区	马, 匚, 乂	㇕, ㇉, 一, 一, ㇗, 乂
渠	洰, 木	氵, 匚, No glyph availabl, 木	⺀, ㇀, 一, ㇗, 匚, 一, 丨, 八
取	耳, 又	耳, 又	二, 丨, 二, ㇇, ㇏
娶	取, 女	耳, 又, 女	二, 丨, 二, ㇇, ㇏, ㇛, 一, 丿
龋	齿, 禹	齿, ㇒, 虫, 冂	丨, 一, 丨, 一, 凵, 人, ㇒, 口, 丨, 𠂉, 冂
趣	走, 取	走, 耳, 又	一, 丨, 一, 龰, 二, 丨, 二, ㇇, ㇏
去	土, 厶	土, 厶	一, 丨, 一, ㇛, 丶
圈	囗, 卷	囗, 二, 丨, 丷, 八, 乚, ㇆	冂, 一, 二, 丨, 丷, 八, 乚, ㇆
颧	雚, 页	艹, 吅, 隹, 页	艹, 吅, ㇒, 丨, 一, 二, 丨, 一, 丶, 一, 丿, 冂, 人
权	木, 又	木, 又	一, 丨, 八, ㇇, ㇏
醛	酉, 荃	酉, 艹, 人, 王	一, 丿, 乚, 口, 一, 艹, 人, 一, 一, 丨, 一
泉	白, 水	白, 水	口, 一, ㇒, 亅, ㇇, 冫
全	人, 王	人, 王	人, 一, 一, 丨, 一
痊	疒, 全	疒, 人, 王	一, 丶, 厂, 丶, 人, 一, 一, 丨, 一
拳	龹, 手	二, 丨, 丷, 八, 手	二, 丨, 丷, 八, ㇒, 亅, 二
犬	大, 丶	犬	人, 一, 丶
券	龹, 刀	二, 丨, 丷, 八, 刀	二, 丨, 丷, 八, ㇆, 丿
劝	又, 力	又, 力	㇇, ㇏, ㇆, 丿
缺	缶, 夬	缶, No glyph availabl, 丨, 人	一, 一, 丨, ㇒, 丨, 凵, 匚, 丨, 人
炔	火, 夬	火, No glyph availabl, 丨, 人	丿, 丶, 冫, 匚, 丨, 人
瘸	疒, 𦙲	疒, 力, 口, 肉	一, 丶, 厂, 丶, ㇆, 丿, 口, 仌, 冂
却	去, 卩	土, 厶, 卩	一, 丨, 一, ㇛, 丶, 丨, ㇆
鹊	昔, 鸟	艹, 一, 日, 鸟	艹, 一, 口, 一, ㇆, ㇉, 丶, 丶, 一
榷	木, 隺	木, 巾, 隹	一, 丨, 八, 冂, 丨, ㇒, 丨, 一, 二, 丨, 一, 丶
确	石, 角	石, 角	一, 丿, 口, ⺈, 冂, 二, 丨
雀	少, 隹	小, 丿, 隹	亅, 八, 丿, ㇒, 丨, 一, 二, 丨, 一, 丶
裙	衤, 君	衤, ⺕, 丨, 口	一, 一, 丨, 一, 丶, 戈, 丨, 冫, 匚, 一, 丨, 口
群	君, 羊	⺕, 丨, 口, 羊	匚, 一, 丨, 口, 一, 二, 丨, 丷
然	肰, 灬	月, 犬, 灬	冂, 二, 人, 一, 丶, 灬
燃	火, 然	火, 月, 犬, 灬	丿, 丶, 冫, 冂, 二, 人, 一, 丶, 灬
冉	冂, 土	冂, 土	冂, 一, 丨, 一
染	氿, 木	氵, 丿, ㇈, 木	⺀, ㇀, 丿, ㇈, 一, 丨, 八
瓤	襄, 瓜	衣, 吅, No glyph availabl, 二, 一, 瓜	一, 丶, ㇒, ㇗, 冫, 吅, 丨, 二, 一, 丿, ㇒, ㇏, ㇛, 丶
壤	土, 襄	土, 衣, 吅, No glyph availabl, 二, 一	一, 丨, 一, 一, 丶, ㇒, ㇗, 冫, 吅, 丨, 二, 一
攘	扌, 襄	扌, 衣, 吅, No glyph availabl, 二, 一	亅, 二, 一, 丶, ㇒, ㇗, 冫, 吅, 丨, 二, 一
嚷	口, 襄	口, 衣, 吅, No glyph availabl, 二, 一	口, 一, 丶, ㇒, ㇗, 冫, 吅, 丨, 二, 一
让	讠, 上	讠, ⺊, 一	㇊, 丶, 丨, 一, 一
饶	饣, 尧	饣, No glyph availabl, 一, 儿	⺈, 乚, ㇂, 一, ㇒, 一, 丿, 乚
扰	扌, 尤	扌, 尢, 丶	亅, 二, 𠂇, 乚, 丶
绕	纟, 尧	纟, No glyph availabl, 一, 儿	㇛, 一, ㇂, 一, ㇒, 一, 丿, 乚
惹	若, 心	艹, 𠂇, 口, 心	艹, 𠂇, 口, 𠁼, ㇃
热	执, 灬	扌, 丿, ㇈, 丶, 灬	亅, 二, 丿, ㇈, 丶, 灬
壬	㇒, 士	㇒, 士	㇒, 一, 丨, 一
仁	亻, 二	亻, 二	㇒, 丨, 二
人	㇒	人	人
忍	刃, 心	刀, 丶, 心	㇆, 丿, 丶, 𠁼, ㇃
韧	韦, 刃	韦, 刀, 丶	一, 二, ㇆, 丨, ㇆, 丿, 丶
任	亻, 壬	亻, ㇒, 士	㇒, 丨, ㇒, 一, 丨, 一
认	讠, 人	讠, 人	㇊, 丶, 人
刃	刀, 丶	刀, 丶	㇆, 丿, 丶
妊	女, 壬	女, ㇒, 士	㇛, 一, 丿, ㇒, 一, 丨, 一
纫	纟, 刃	纟, 刀, 丶	㇛, 一, ㇆, 丿, 丶
扔	扌, 乃	扌, ㇎, 丿	亅, 二, ㇎, 丿
仍	亻, 乃	亻, ㇎, 丿	㇒, 丨, ㇎, 丿
日	口, 一	日	口, 一
戎	戈, 𠂇	戈, 𠂇	戈, 𠂇
茸	艹, 耳	艹, 耳	艹, 二, 丨, 二
蓉	艹, 容	艹, 宀, 谷	艹, 冖, 丶, 八, 人, 口
荣	艹, No glyph available	艹, 冖, 木	艹, 冖, 一, 丨, 八
融	鬲, 虫	鬲, 虫	一, 口, 冂, 丷, 一, 丨, 口, 丨, 𠂉
熔	火, 容	火, 宀, 谷	丿, 丶, 冫, 冖, 丶, 八, 人, 口
溶	氵, 容	氵, 宀, 谷	⺀, ㇀, 冖, 丶, 八, 人, 口
容	宀, 谷	宀, 谷	冖, 丶, 八, 人, 口
绒	纟, 戎	纟, 戈, 𠂇	㇛, 一, 戈, 𠂇
冗	冖, 几	冖, 几	冖, 丿, ㇠
揉	扌, 柔	扌, 矛, 木	亅, 二, 龴, ㇖, 亅, ㇒, 一, 丨, 八
柔	矛, 木	矛, 木	龴, ㇖, 亅, ㇒, 一, 丨, 八
肉	仌, 冂	肉	仌, 冂
茹	艹, 如	艹, 女, 口	艹, ㇛, 一, 丿, 口
蠕	虫, 需	虫, 雨, 而	口, 丨, 𠂉, 一, 冂, 丨, 丶, ㇀, 冫, 一, 丿, 冂, 丨
儒	亻, 需	亻, 雨, 而	㇒, 丨, 一, 冂, 丨, 丶, ㇀, 冫, 一, 丿, 冂, 丨
孺	子, 需	子, 雨, 而	㇇, 亅, 一, 一, 冂, 丨, 丶, ㇀, 冫, 一, 丿, 冂, 丨
如	女, 口	女, 口	㇛, 一, 丿, 口
辱	辰, 寸	辰, 寸	厂, 二, 乚, 冫, 𠂇, 亅, 丶
乳	孚, 乚	爫, 子, 乚	爫, ㇇, 亅, 一, 乚
汝	氵, 女	氵, 女	⺀, ㇀, ㇛, 一, 丿
入	人	入	入
褥	衤, 辱	衤, 辰, 寸	一, 一, 丨, 一, 丶, 戈, 丨, 冫, 厂, 二, 乚, 冫, 𠂇, 亅, 丶
软	车, 欠	车, 欠	乚, 一, 一, 丨, ⺈, 人
阮	阝, 元	阝, 二, 儿	丨, ㇌, 二, 丿, 乚
蕊	艹, 惢	艹, 惢	艹, 惢
瑞	王, 耑	王, 山, 而	一, 一, 丨, 一, 丨, 凵, 一, 丿, 冂, 丨
锐	钅, 兑	钅, 丷, 口, 儿	丿, 一, 乚, 二, 丷, 口, 丿, 乚
闰	门, 王	门, 王	丶, 丨, ㇆, 一, 一, 丨, 一
润	氵, 闰	氵, 门, 王	⺀, ㇀, 丶, 丨, ㇆, 一, 一, 丨, 一
若	艹, 右	艹, 𠂇, 口	艹, 𠂇, 口
弱	No glyph available	弱	弱
撒	扌, 散	扌, 艹, 一, 月, ⺙	亅, 二, 艹, 一, 冂, 二, 丿, 一, 乂
洒	氵, 西	氵, 西	⺀, ㇀, 一, 丿, 乚, 冂, 一
萨	艹, No glyph available	艹, 阝, 立, 厂	艹, 丨, ㇌, 一, 丶, 丷, 一, 厂
腮	月, 思	月, 田, 心	冂, 二, 冂, 一, 丨, 一, 𠁼, ㇃
鳃	鱼, 思	鱼, 田, 心	⺈, 冂, 一, 丨, 一, 一, 冂, 一, 丨, 一, 𠁼, ㇃
塞	宀, No glyph available	宀, No glyph availabl, 二, 一, 八, 土	冖, 丶, 丨, 二, 一, 八, 一, 丨, 一
赛	宀, No glyph available	宀, No glyph availabl, 二, 一, 八, 贝	冖, 丶, 丨, 二, 一, 八, 冂, 人
三	一, 二	一, 二	一, 二
叁	No glyph available, 三	厶, 大, 一, 二	㇛, 丶, 人, 一, 一, 二
伞	人, No glyph available	人, 十, 丷	人, 一, 丨, 丷
散	No glyph available, ⺙	艹, 一, 月, ⺙	艹, 一, 冂, 二, 丿, 一, 乂
桑	叒, 木	叒, 木	叒, 一, 丨, 八
嗓	口, 桑	口, 叒, 木	口, 叒, 一, 丨, 八
丧	No glyph available, No glyph available	土, 丷, 乚, No glyph availabl	一, 丨, 一, 丷, 乚, 冫
搔	扌, 蚤	扌, 又, 丶, 虫	亅, 二, ㇇, ㇏, 丶, 口, 丨, 𠂉
骚	马, 蚤	马, 又, 丶, 虫	㇕, ㇉, 一, ㇇, ㇏, 丶, 口, 丨, 𠂉
扫	扌, 彐	扌, 彐	亅, 二, ㇕, 二
嫂	女, 叟	女, 臼, 丨, 又	㇛, 一, 丿, 臼, 丨, ㇇, ㇏
瑟	玨, 必	玨, 心, 丿	玨, 𠁼, ㇃, 丿
色	⺈, 巴	色	⺈, 丨, 匚, 丨, 乚
涩	氵, No glyph available	氵, 刀, 丶, 止	⺀, ㇀, ㇆, 丿, 丶, 丨, 一, 丨, 一
森	木	森	森
僧	亻, 曾	亻, 丷, 口, 丨, 丷, 日	㇒, 丨, 丷, 口, 丨, 丷, 口, 一
莎	艹, 沙	艹, 氵, 小, 丿	艹, ⺀, ㇀, 亅, 八, 丿
砂	石, 少	石, 小, 丿	一, 丿, 口, 亅, 八, 丿
杀	乂, 朩	乂, 十, 小	乂, 一, 丨, 亅, 八
刹	杀, 刂	乂, 十, 小, 刂	乂, 一, 丨, 亅, 八, 亅, 丨
沙	氵, 少	氵, 小, 丿	⺀, ㇀, 亅, 八, 丿
纱	纟, 少	纟, 小, 丿	㇛, 一, 亅, 八, 丿
傻	亻, No glyph available	亻, 囗, 丶, 乂, 八, 夂	㇒, 丨, 冂, 一, 丶, 乂, 八, ㇇, ㇏, ㇒
啥	口, 舍	口, 人, 干, 口	口, 人, 一, 一, 丨, 口
煞	No glyph available, 灬	⺈, 彐, ⺙, 灬	⺈, ㇕, 二, 丿, 一, 乂, 灬
筛	⺮, 师	⺮, No glyph availabl, 一, 巾	⺮, 丨, 丨, 一, 冂, 丨
晒	日, 西	日, 西	口, 一, 一, 丿, 乚, 冂, 一
珊	王, 册	王, 册	一, 一, 丨, 一, 册
苫	艹, 占	艹, ⺊, 口	艹, 丨, 一, 口
杉	木, 彡	木, 彡	一, 丨, 八, 彡
山	丨, 凵	山	丨, 凵
删	册, 刂	册, 刂	册, 亅, 丨
煽	火, 扇	火, 户, 羽	丿, 丶, 冫, 丨, 匚, 丶, 羽
衫	衤, 彡	衤, 彡	一, 一, 丨, 一, 丶, 戈, 丨, 冫, 彡
闪	门, 人	门, 人	丶, 丨, ㇆, 人
陕	阝, 夹	阝, 人, 二, 丷	丨, ㇌, 人, 二, 丷
擅	扌, 亶	扌, 亠, 回, 日, 一	亅, 二, 一, 丶, 回, 口, 一, 一
赡	贝, 詹	贝, ⺈, 厂, 八, 言	冂, 人, ⺈, 厂, 八, 一, 丶, 二, 口
膳	月, 善	月, 羊, 丷, 一, 口	冂, 二, 一, 二, 丨, 丷, 丷, 一, 口
善	No glyph available, 口	羊, 丷, 一, 口	一, 二, 丨, 丷, 丷, 一, 口
汕	氵, 山	氵, 山	⺀, ㇀, 丨, 凵
扇	户, 羽	户, 羽	丨, 匚, 丶, 羽
缮	纟, 善	纟, 羊, 丷, 一, 口	㇛, 一, 一, 二, 丨, 丷, 丷, 一, 口
墒	土, 商	土, 亠, 丷, 冂, 八, 口	一, 丨, 一, 一, 丶, 丷, 冂, 八, 口
伤	亻, No glyph available	亻, 丿, 一, 力	㇒, 丨, 丿, 一, ㇆, 丿
商	No glyph available, 冏	亠, 丷, 冂, 八, 口	一, 丶, 丷, 冂, 八, 口
赏	No glyph available, 贝	⺌, 冖, 口, 贝	丨, 丷, 冖, 口, 冂, 人
晌	日, 向	日, 宀, 口	口, 一, 冖, 丶, 口
上	⺊, 一	⺊, 一	丨, 一, 一
尚	No glyph available, 口	⺌, 冂, 口	丨, 丷, 冂, 口
裳	No glyph available, 衣	⺌, 冖, 口, 衣	丨, 丷, 冖, 口, 一, 丶, ㇒, ㇗, 冫
梢	木, 肖	木, ⺌, 月	一, 丨, 八, 丨, 丷, 冂, 二
捎	扌, 肖	扌, ⺌, 月	亅, 二, 丨, 丷, 冂, 二
稍	禾, 肖	禾, ⺌, 月	㇒, 一, 丨, 八, 丨, 丷, 冂, 二
烧	火, 尧	火, No glyph availabl, 一, 儿	丿, 丶, 冫, ㇂, 一, ㇒, 一, 丿, 乚
芍	艹, 勺	艹, 勹, 丶	艹, ㇆, ㇒, 丶
勺	勹, 丶	勹, 丶	㇆, ㇒, 丶
韶	音, 召	音, 刀, 口	一, 丶, 丷, 一, 口, 一, ㇆, 丿, 口
少	小, 丿	小, 丿	亅, 八, 丿
哨	口, 肖	口, ⺌, 月	口, 丨, 丷, 冂, 二
邵	召, 阝	刀, 口, 阝	㇆, 丿, 口, 丨, ㇌
绍	纟, 召	纟, 刀, 口	㇛, 一, ㇆, 丿, 口
奢	大, 者	大, 耂, 日	人, 一, 耂, 口, 一
赊	贝, 佘	贝, 人, 示	冂, 人, 人, 二, 亅, 八
蛇	虫, 它	虫, 宀, 匕	口, 丨, 𠂉, 冖, 丶, 乚, ㇒
舌	千, 口	舌	㇒, 一, 丨, 口
舍	人, No glyph available	人, 干, 口	人, 一, 一, 丨, 口
赦	赤, ⺙	赤, ⺙	一, 丨, 一, 丨, 亅, 八, 丿, 一, 乂
摄	扌, 聂	扌, 耳, 双	亅, 二, 二, 丨, 二, 双
射	身, 寸	身, 寸	𠂎, 丶, 二, 丿, 𠂇, 亅, 丶
慑	忄, 聂	忄, 耳, 双	丨, 八, 二, 丨, 二, 双
涉	氵, 步	氵, 止, 小, 丿	⺀, ㇀, 丨, 一, 丨, 一, 亅, 八, 丿
社	礻, 土	礻, 土	一, 一, 丨, 一, 丶, 戈, 丨, 丶, 一, 丨, 一
设	讠, 殳	讠, 殳	㇊, 丶, 丿, ㇠, ㇇, ㇏
砷	石, 申	石, 日, 丨	一, 丿, 口, 口, 一, 丨
申	日, 丨	日, 丨	口, 一, 丨
呻	口, 申	口, 日, 丨	口, 口, 一, 丨
伸	亻, 申	亻, 日, 丨	㇒, 丨, 口, 一, 丨
身	𨈑, 丿	身	𠂎, 丶, 二, 丿
深	氵, 罙	氵, ⺳, 木	⺀, ㇀, 冖, 八, 一, 丨, 八
娠	女, 辰	女, 辰	㇛, 一, 丿, 厂, 二, 乚, 冫
绅	纟, 申	纟, 日, 丨	㇛, 一, 口, 一, 丨
神	礻, 申	礻, 日, 丨	一, 一, 丨, 一, 丶, 戈, 丨, 丶, 口, 一, 丨
沈	氵, 冘	氵, 巾, 乚	⺀, ㇀, 冂, 丨, 乚
审	宀, 申	宀, 日, 丨	冖, 丶, 口, 一, 丨
婶	女, 审	女, 宀, 日, 丨	㇛, 一, 丿, 冖, 丶, 口, 一, 丨
甚	甘, 匹	甘, 匚, 儿	艹, 二, 一, ㇗, 丿, 乚
肾	No glyph available, 月	丨, 丨, 又, 月	丨, 丨, ㇇, ㇏, 冂, 二
慎	忄, 真	忄, 十, 目, 一, 八	丨, 八, 一, 丨, 口, 二, 一, 八
渗	氵, 参	氵, 厶, 大, 彡	⺀, ㇀, ㇛, 丶, 人, 一, 彡
声	士, 𠃜	士, 丨, No glyph availabl, 丨	一, 丨, 一, 丨, 匚, 丨
生	龶, ㇒	生	龶, ㇒
甥	生, 男	生, 田, 力	龶, ㇒, 冂, 一, 丨, 一, ㇆, 丿
牲	牛, 生	牛, 生	二, 丨, ㇒, 龶, ㇒
升	艹, ㇒	艹, ㇒	艹, ㇒
绳	纟, 黾	纟, 黾	㇛, 一, 口, 口, 一, 丨, 乚
省	少, 目	小, 丿, 目	亅, 八, 丿, 口, 二
盛	成, 皿	一, 丿, ㇆, 戈, 皿	一, 丿, ㇆, 戈, 冂, 丨, 一
剩	乘, 刂	禾, 北, 刂	㇒, 一, 丨, 八, 北, 亅, 丨
胜	月, 生	月, 生	冂, 二, 龶, ㇒
圣	又, 土	又, 土	㇇, ㇏, 一, 丨, 一
师	No glyph available, 帀	No glyph availabl, 一, 巾	丨, 丨, 一, 冂, 丨
失	夫, ㇒	人, 二, ㇒	人, 二, ㇒
狮	犭, 师	犭, No glyph availabl, 一, 巾	㇁, ㇒, 丨, 丨, 一, 冂, 丨
施	方, 㐌	方, 丿, 一, 乚, ㇆, 丨	一, 丶, 丿, ㇆, 丿, 一, 乚, ㇆, 丨
湿	氵, 显	氵, 日, No glyph availabl, 丷, 一	⺀, ㇀, 口, 一, 丨, 丷, 一
诗	讠, 寺	讠, 土, 寸	㇊, 丶, 一, 丨, 一, 𠂇, 亅, 丶
尸	丨, No glyph available	尸	丨, 匚
虱	㇠, 䖝	㇠, ㇒, 虫	㇠, ㇒, 口, 丨, 𠂉
十	一, 丨	十	一, 丨
石	丆, 口	石	一, 丿, 口
拾	扌, 合	扌, 人, 一, 口	亅, 二, 人, 一, 口
时	日, 寸	日, 寸	口, 一, 𠂇, 亅, 丶
什	亻, 十	亻, 十	㇒, 丨, 一, 丨
食	亽, 艮	食	人, 丶, 丨, ㇕, 二, 乚, 冫
蚀	饣, 虫	饣, 虫	⺈, 乚, 口, 丨, 𠂉
实	宀, 头	宀, 大, ⺀	冖, 丶, 人, 一, ⺀
识	讠, 只	讠, 口, 八	㇊, 丶, 口, 八
史	中, 乂	口, 丨, 乂	口, 丨, 乂
矢	𠂉, 大	矢	丿, 一, 人, 一
使	亻, 吏	亻, 十, 口, 丨, 乂	㇒, 丨, 一, 丨, 口, 丨, 乂
屎	尸, 米	尸, 米	丨, 匚, 一, 丨, 八, 丷
驶	马, 史	马, 口, 丨, 乂	㇕, ㇉, 一, 口, 丨, 乂
始	女, 台	女, 厶, 口	㇛, 一, 丿, ㇛, 丶, 口
式	弋, 工	弋, 工	弋, 一, 丨, 一
示	二, 小	示	二, 亅, 八
士	十, 一	士	一, 丨, 一
世	㇗, 廿	㇗, 廿	㇗, 卄, 一
柿	木, 市	木, 亠, 巾	一, 丨, 八, 一, 丶, 冂, 丨
事	No glyph available, 亅	十, 口, 丨, ⺺, 亅	一, 丨, 口, 丨, 匚, 一, 丨, 亅
拭	扌, 式	扌, 弋, 工	亅, 二, 弋, 一, 丨, 一
誓	折, 言	扌, 斤, 言	亅, 二, 丿, ㇒, 一, 丨, 一, 丶, 二, 口
逝	辶, 折	辶, 扌, 斤	丶, ㇆, ㇝, 亅, 二, 丿, ㇒, 一, 丨
势	执, 力	扌, 丿, ㇈, 丶, 力	亅, 二, 丿, ㇈, 丶, ㇆, 丿
是	日, 𤴓	日, 一, 龰	口, 一, 一, 龰
嗜	口, 耆	口, 老, 日	口, 耂, 乚, ㇒, 口, 一
噬	口, 筮	口, ⺮, 工, 从	口, ⺮, 一, 丨, 一, 从
适	辶, 舌	辶, 舌	丶, ㇆, ㇝, ㇒, 一, 丨, 口
仕	亻, 士	亻, 士	㇒, 丨, 一, 丨, 一
侍	亻, 寺	亻, 土, 寸	㇒, 丨, 一, 丨, 一, 𠂇, 亅, 丶
释	釆, No glyph available	釆, 又, 二, 丨	㇒, 一, 丨, 八, 丷, ㇇, ㇏, 二, 丨
饰	饣, No glyph available	饣, 丿, 一, 巾	⺈, 乚, 丿, 一, 冂, 丨
氏	No glyph available, No glyph available	氏	㇒, ㇗, ㇂, 一
市	亠, 巾	亠, 巾	一, 丶, 冂, 丨
恃	忄, 寺	忄, 土, 寸	丨, 八, 一, 丨, 一, 𠂇, 亅, 丶
室	宀, 至	宀, 至	冖, 丶, 一, ㇛, 丶, 一, 丨, 一
视	礻, 见	礻, 见	一, 一, 丨, 一, 丶, 戈, 丨, 丶, 冂, 丿, 乚
试	讠, 式	讠, 弋, 工	㇊, 丶, 弋, 一, 丨, 一
收	丩, ⺙	丨, ㇙, ⺙	丨, ㇙, 丿, 一, 乂
手	㇒, 扌	手	㇒, 亅, 二
首	䒑, 自	首	丷, 一, 口, 二, 丶
守	宀, 寸	宀, 寸	冖, 丶, 𠂇, 亅, 丶
寿	丰, 寸	一, 二, 丨, 寸	一, 二, 丨, 𠂇, 亅, 丶
授	扌, 受	扌, 爫, 冖, 又	亅, 二, 爫, 冖, ㇇, ㇏
售	隹, 口	隹, 口	㇒, 丨, 一, 二, 丨, 一, 丶, 口
受	No glyph available, 又	爫, 冖, 又	爫, 冖, ㇇, ㇏
瘦	疒, 叟	疒, 臼, 丨, 又	一, 丶, 厂, 丶, 臼, 丨, ㇇, ㇏
兽	丷, No glyph available	丷, 田, 一, 口	丷, 冂, 一, 丨, 一, 一, 口
蔬	艹, 疏	艹, ⺪, 亠, 厶, 儿, 丨	艹, ㇖, 丨, 一, 丨, 一, 一, 丶, ㇛, 丶, 丿, 乚, 丨
枢	木, 区	木, 匚, 乂	一, 丨, 八, 一, ㇗, 乂
梳	木, 㐬	木, 亠, 厶, 儿, 丨	一, 丨, 八, 一, 丶, ㇛, 丶, 丿, 乚, 丨
殊	歹, 朱	歹, 木, 一, ㇒	一, 夕, 一, 丨, 八, 一, ㇒
抒	扌, 予	扌, 龴, ㇖, 亅	亅, 二, 龴, ㇖, 亅
输	车, 俞	车, 人, 一, 月, 刂	乚, 一, 一, 丨, 人, 一, 冂, 二, 亅, 丨
叔	尗, 又	⺊, 一, 小, 又	丨, 一, 一, 亅, 八, ㇇, ㇏
舒	舍, 予	人, 干, 口, 龴, ㇖, 亅	人, 一, 一, 丨, 口, 龴, ㇖, 亅
淑	氵, 叔	氵, ⺊, 一, 小, 又	⺀, ㇀, 丨, 一, 一, 亅, 八, ㇇, ㇏
疏	⺪, 㐬	⺪, 亠, 厶, 儿, 丨	㇖, 丨, 一, 丨, 一, 一, 丶, ㇛, 丶, 丿, 乚, 丨
书	No glyph available, 丶	No glyph availabl, 丨, 丶	㇆, 丨, 丶
赎	贝, 卖	贝, 十, ㇖, 大, ⺀	冂, 人, 一, 丨, ㇖, 人, 一, ⺀
孰	享, 丸	亠, 口, 子, 丿, ㇈, 丶	一, 丶, 口, ㇇, 亅, 一, 丿, ㇈, 丶
熟	孰, 灬	亠, 口, 子, 丿, ㇈, 丶, 灬	一, 丶, 口, ㇇, 亅, 一, 丿, ㇈, 丶, 灬
薯	艹, 署	艹, 罒, 耂, 日	艹, 口, 丨, 耂, 口, 一
暑	日, 者	日, 耂, 日	口, 一, 耂, 口, 一
曙	日, 署	日, 罒, 耂, 日	口, 一, 口, 丨, 耂, 口, 一
署	罒, 者	罒, 耂, 日	口, 丨, 耂, 口, 一
蜀	罒, 𠣜	罒, 勹, 虫	口, 丨, ㇆, ㇒, 口, 丨, 𠂉
黍	禾, 氽	黍	㇒, 一, 丨, 八, 人, 亅, ㇇, 冫
鼠	臼, No glyph available	鼠	臼, 乚, 丶, ㇀, 冫
属	尸, 禹	尸, ㇒, 虫, 冂	丨, 匚, ㇒, 口, 丨, 𠂉, 冂
术	木, 丶	木, 丶	一, 丨, 八, 丶
述	辶, 术	辶, 木, 丶	丶, ㇆, ㇝, 一, 丨, 八, 丶
树	木, 对	木, 又, 寸	一, 丨, 八, ㇇, ㇏, 𠂇, 亅, 丶
束	木, 口	木, 口	一, 丨, 八, 口
戍	戊, 丶	厂, 戈, 丶	厂, 戈, 丶
竖	No glyph available, 立	丨, 丨, 又, 立	丨, 丨, ㇇, ㇏, 一, 丶, 丷, 一
墅	野, 土	里, 龴, ㇖, 亅, 土	冂, 一, 丨, 一, 一, 丨, 一, 龴, ㇖, 亅, 一, 丨, 一
庶	No glyph available, 灬	广, 廿, 灬	厂, 丶, 卄, 一, 灬
数	娄, ⺙	米, 女, ⺙	一, 丨, 八, 丷, ㇛, 一, 丿, 丿, 一, 乂
漱	涑, 欠	氵, 木, 口, 欠	⺀, ㇀, 一, 丨, 八, 口, ⺈, 人
恕	如, 心	女, 口, 心	㇛, 一, 丿, 口, 𠁼, ㇃
刷	𡰯, 刂	尸, 巾, 刂	丨, 匚, 冂, 丨, 亅, 丨
耍	而, 女	而, 女	一, 丿, 冂, 丨, ㇛, 一, 丿
摔	扌, 率	扌, 亠, 幺, 冫, No glyph availabl, 十	亅, 二, 一, 丶, ㇛, 丶, 丶, ㇀, 冫, 一, 丨
衰	衣, No glyph available	衣, 囗, 一	一, 丶, ㇒, ㇗, 冫, 冂, 一, 一
甩	用, 乚	甩	冂, 二, 丨, 乚
帅	No glyph available, 巾	No glyph availabl, 巾	丨, 丨, 冂, 丨
栓	木, 全	木, 人, 王	一, 丨, 八, 人, 一, 一, 丨, 一
拴	扌, 全	扌, 人, 王	亅, 二, 人, 一, 一, 丨, 一
霜	雨, 相	雨, 木, 目	一, 冂, 丨, 丶, ㇀, 冫, 一, 丨, 八, 口, 二
双	又	双	双
爽	大, 㸚	大, 㸚	人, 一, 㸚
谁	讠, 隹	讠, 隹	㇊, 丶, ㇒, 丨, 一, 二, 丨, 一, 丶
水	亅, No glyph available	水	亅, ㇇, 冫
睡	目, 垂	目, ㇒, 十, 士, 艹	口, 二, ㇒, 一, 丨, 一, 丨, 一, 艹
税	禾, 兑	禾, 丷, 口, 儿	㇒, 一, 丨, 八, 丷, 口, 丿, 乚
吮	口, 允	口, 厶, 儿	口, ㇛, 丶, 丿, 乚
瞬	目, 舜	目, 爫, 冖, 舛	口, 二, 爫, 冖, 夕, 一, 丨, ㇗, 丨
顺	川, 页	川, 页	川, 一, 丿, 冂, 人
舜	爫, No glyph available	爫, 冖, 舛	爫, 冖, 夕, 一, 丨, ㇗, 丨
说	讠, 兑	讠, 丷, 口, 儿	㇊, 丶, 丷, 口, 丿, 乚
硕	石, 页	石, 页	一, 丿, 口, 一, 丿, 冂, 人
朔	屰, 月	丷, 一, 屮, 月	丷, 一, 丨, 凵, 冂, 二
烁	火, 乐	火, ㇒, ㇗, 小	丿, 丶, 冫, ㇒, ㇗, 亅, 八
斯	其, 斤	甘, 一, 八, 斤	艹, 二, 一, 八, 丿, ㇒, 一, 丨
撕	扌, 斯	扌, 甘, 一, 八, 斤	亅, 二, 艹, 二, 一, 八, 丿, ㇒, 一, 丨
嘶	口, 斯	口, 甘, 一, 八, 斤	口, 艹, 二, 一, 八, 丿, ㇒, 一, 丨
思	田, 心	田, 心	冂, 一, 丨, 一, 𠁼, ㇃
私	禾, 厶	禾, 厶	㇒, 一, 丨, 八, ㇛, 丶
司	㇆, 𠮛	㇆, 一, 口	㇆, 一, 口
丝	No glyph available, 一	No glyph availabl, 一	㇛, 一
死	歹, 匕	歹, 匕	一, 夕, 乚, ㇒
肆	镸, 聿	镸, 聿	彐, 一, ㇛, 丶, 匚, 一, 丨, 二, 丨
寺	土, 寸	土, 寸	一, 丨, 一, 𠂇, 亅, 丶
嗣	No glyph available, 司	口, 冂, 艹, ㇆, 一, 口	口, 冂, 艹, ㇆, 一, 口
四	囗, 儿	囗, 儿	冂, 一, 丿, 乚
伺	亻, 司	亻, ㇆, 一, 口	㇒, 丨, ㇆, 一, 口
似	亻, 以	亻, 乚, 丶, 人	㇒, 丨, 乚, 丶, 人
饲	饣, 司	饣, ㇆, 一, 口	⺈, 乚, ㇆, 一, 口
巳	尸, 乚	巳	丨, 匚, 乚
松	木, 公	木, 八, 厶	一, 丨, 八, 八, ㇛, 丶
耸	从, 耳	从, 耳	从, 二, 丨, 二
怂	从, 心	从, 心	从, 𠁼, ㇃
颂	公, 页	八, 厶, 页	八, ㇛, 丶, 一, 丿, 冂, 人
送	辶, 关	辶, 丷, 一, 大	丶, ㇆, ㇝, 丷, 一, 人, 一
宋	宀, 木	宀, 木	冖, 丶, 一, 丨, 八
讼	讠, 公	讠, 八, 厶	㇊, 丶, 八, ㇛, 丶
诵	讠, 甬	讠, 龴, 用	㇊, 丶, 龴, 冂, 二, 丨
搜	扌, 叟	扌, 臼, 丨, 又	亅, 二, 臼, 丨, ㇇, ㇏
艘	舟, 叟	舟, 臼, 丨, 又	冂, 丶, ⺀, 一, 臼, 丨, ㇇, ㇏
擞	扌, 数	扌, 米, 女, ⺙	亅, 二, 一, 丨, 八, 丷, ㇛, 一, 丿, 丿, 一, 乂
嗽	口, 欶	口, 木, 口, 欠	口, 一, 丨, 八, 口, ⺈, 人
苏	艹, 办	艹, 力, 八	艹, ㇆, 丿, 八
酥	酉, 禾	酉, 禾	一, 丿, 乚, 口, 一, ㇒, 一, 丨, 八
俗	亻, 谷	亻, 谷	㇒, 丨, 八, 人, 口
素	龶, 糸	龶, 糸	龶, ㇛, 丶, 亅, 八
速	辶, 束	辶, 木, 口	丶, ㇆, ㇝, 一, 丨, 八, 口
粟	覀, 米	覀, 米	覀, 一, 丨, 八, 丷
僳	亻, No glyph available	亻, 西, 米	㇒, 丨, 一, 丿, 乚, 冂, 一, 一, 丨, 八, 丷
塑	朔, 土	丷, 一, 屮, 月, 土	丷, 一, 丨, 凵, 冂, 二, 一, 丨, 一
溯	氵, 朔	氵, 丷, 一, 屮, 月	⺀, ㇀, 丷, 一, 丨, 凵, 冂, 二
宿	宀, 佰	宀, 亻, 一, 白	冖, 丶, ㇒, 丨, 一, 口, 一, ㇒
诉	讠, 斥	讠, 斤, 丶	㇊, 丶, 丿, ㇒, 一, 丨, 丶
肃	⺺, No glyph available	⺺, No glyph availabl, 小	匚, 一, 丨, 丨, 亅, 八
酸	酉, 夋	酉, 厶, 八, 夂	一, 丿, 乚, 口, 一, ㇛, 丶, 八, ㇇, ㇏, ㇒
蒜	艹, 祘	艹, 祘	艹, 祘
算	⺮, 𥃲	⺮, 目, 艹	⺮, 口, 二, 艹
虽	口, 虫	口, 虫	口, 口, 丨, 𠂉
隋	阝, No glyph available	阝, 𠂇, 工, 月	丨, ㇌, 𠂇, 一, 丨, 一, 冂, 二
随	阝, 迶	阝, 辶, 𠂇, 月	丨, ㇌, 丶, ㇆, ㇝, 𠂇, 冂, 二
绥	纟, 妥	纟, 爫, 女	㇛, 一, 爫, ㇛, 一, 丿
髓	骨, 遀	骨, 辶, 月, 𠂇, 工	冂, ㇆, 冂, 冂, 二, 丶, ㇆, ㇝, 冂, 二, 𠂇, 一, 丨, 一
碎	石, 卒	石, 亠, 从, 十	一, 丿, 口, 一, 丶, 从, 一, 丨
岁	山, 夕	山, 夕	丨, 凵, 夕
穗	禾, 惠	禾, 十, 日, 丨, No glyph availabl, 心	㇒, 一, 丨, 八, 一, 丨, 口, 一, 丨, 𠂉, 𠁼, ㇃
遂	辶, 㒸	辶, 丷, 豕	丶, ㇆, ㇝, 丷, 一, ㇆, ㇒, ㇒, 冫
隧	阝, 遂	阝, 辶, 丷, 豕	丨, ㇌, 丶, ㇆, ㇝, 丷, 一, ㇆, ㇒, ㇒, 冫
祟	出, 示	出, 示	出, 二, 亅, 八
孙	子, 小	子, 小	㇇, 亅, 一, 亅, 八
损	扌, 员	扌, 口, 贝	亅, 二, 口, 冂, 人
笋	⺮, 尹	⺮, ⺕, 丨	⺮, 匚, 一, 丨
蓑	艹, 衰	艹, 衣, 囗, 一	艹, 一, 丶, ㇒, ㇗, 冫, 冂, 一, 一
梭	木, 夋	木, 厶, 八, 夂	一, 丨, 八, ㇛, 丶, 八, ㇇, ㇏, ㇒
唆	口, 夋	口, 厶, 八, 夂	口, ㇛, 丶, 八, ㇇, ㇏, ㇒
缩	纟, 宿	纟, 宀, 亻, 一, 白	㇛, 一, 冖, 丶, ㇒, 丨, 一, 口, 一, ㇒
琐	王, No glyph available	王, ⺌, 贝	一, 一, 丨, 一, 丨, 丷, 冂, 人
索	No glyph available, 糸	十, 冖, 糸	一, 丨, 冖, ㇛, 丶, 亅, 八
锁	钅, No glyph available	钅, ⺌, 贝	丿, 一, 乚, 二, 丨, 丷, 冂, 人
所	戶, 斤	戶, 斤	丿, ㇒, 匚, 丿, ㇒, 一, 丨
塌	土, 𦐇	土, 日, 羽	一, 丨, 一, 口, 一, 羽
他	亻, 也	亻, 乚, ㇆, 丨	㇒, 丨, 乚, ㇆, 丨
它	宀, 匕	宀, 匕	冖, 丶, 乚, ㇒
她	女, 也	女, 乚, ㇆, 丨	㇛, 一, 丿, 乚, ㇆, 丨
塔	土, 荅	土, 艹, 人, 一, 口	一, 丨, 一, 艹, 人, 一, 口
獭	犭, 赖	犭, 木, 口, ⺈, 贝	㇁, ㇒, 一, 丨, 八, 口, ⺈, 冂, 人
挞	扌, 达	扌, 辶, 大	亅, 二, 丶, ㇆, ㇝, 人, 一
蹋	⻊, 𦐇	⻊, 日, 羽	口, 丨, 一, 丨, 一, 口, 一, 羽
踏	⻊, 沓	⻊, 水, 日	口, 丨, 一, 丨, 一, 亅, ㇇, 冫, 口, 一
胎	月, 台	月, 厶, 口	冂, 二, ㇛, 丶, 口
苔	艹, 台	艹, 厶, 口	艹, ㇛, 丶, 口
抬	扌, 台	扌, 厶, 口	亅, 二, ㇛, 丶, 口
台	厶, 口	厶, 口	㇛, 丶, 口
泰	𡗗, 氺	一, 二, 丨, 八, 氺	一, 二, 丨, 八, 亅, 丶, ㇀, 冫
酞	酉, 太	酉, 大, 丶	一, 丿, 乚, 口, 一, 人, 一, 丶
太	大, 丶	大, 丶	人, 一, 丶
态	太, 心	大, 丶, 心	人, 一, 丶, 𠁼, ㇃
汰	氵, 太	氵, 大, 丶	⺀, ㇀, 人, 一, 丶
坍	土, 丹	土, 冂, 亠	一, 丨, 一, 冂, 一, 丶
摊	扌, 难	扌, 又, 隹	亅, 二, ㇇, ㇏, ㇒, 丨, 一, 二, 丨, 一, 丶
贪	今, 贝	人, 丶, ㇇, 贝	人, 丶, ㇇, 冂, 人
瘫	疒, 难	疒, 又, 隹	一, 丶, 厂, 丶, ㇇, ㇏, ㇒, 丨, 一, 二, 丨, 一, 丶
滩	氵, 难	氵, 又, 隹	⺀, ㇀, ㇇, ㇏, ㇒, 丨, 一, 二, 丨, 一, 丶
坛	土, 云	土, 二, 厶	一, 丨, 一, 二, ㇛, 丶
檀	木, 亶	木, 亠, 回, 日, 一	一, 丨, 八, 一, 丶, 回, 口, 一, 一
痰	疒, 炎	疒, 炎	一, 丶, 厂, 丶, 炎
潭	氵, No glyph available	氵, 西, 日, 十	⺀, ㇀, 一, 丿, 乚, 冂, 一, 口, 一, 一, 丨
谭	讠, No glyph available	讠, 西, 日, 十	㇊, 丶, 一, 丿, 乚, 冂, 一, 口, 一, 一, 丨
谈	讠, 炎	讠, 炎	㇊, 丶, 炎
坦	土, 旦	土, 日, 一	一, 丨, 一, 口, 一, 一
毯	毛, 炎	毛, 炎	㇒, 二, 乚, 炎
袒	衤, 旦	衤, 日, 一	一, 一, 丨, 一, 丶, 戈, 丨, 冫, 口, 一, 一
碳	石, 炭	石, 山, 𠂇, 火	一, 丿, 口, 丨, 凵, 𠂇, 丿, 丶, 冫
探	扌, 罙	扌, ⺳, 木	亅, 二, 冖, 八, 一, 丨, 八
叹	口, 又	口, 又	口, ㇇, ㇏
炭	山, 灰	山, 𠂇, 火	丨, 凵, 𠂇, 丿, 丶, 冫
汤	氵, 𠃓	氵, ㇎, No glyph availabl	⺀, ㇀, ㇎, ㇒
塘	土, 唐	土, 广, ⺺, 口	一, 丨, 一, 厂, 丶, 匚, 一, 丨, 口
搪	扌, 唐	扌, 广, ⺺, 口	亅, 二, 厂, 丶, 匚, 一, 丨, 口
堂	No glyph available, 土	⺌, 冖, 口, 土	丨, 丷, 冖, 口, 一, 丨, 一
棠	龸, 呆	⺌, 冖, 口, 木	丨, 丷, 冖, 口, 一, 丨, 八
膛	月, 堂	月, ⺌, 冖, 口, 土	冂, 二, 丨, 丷, 冖, 口, 一, 丨, 一
唐	广, No glyph available	广, ⺺, 口	厂, 丶, 匚, 一, 丨, 口
糖	米, 唐	米, 广, ⺺, 口	一, 丨, 八, 丷, 厂, 丶, 匚, 一, 丨, 口
倘	亻, 尚	亻, ⺌, 冂, 口	㇒, 丨, 丨, 丷, 冂, 口
躺	身, 尚	身, ⺌, 冂, 口	𠂎, 丶, 二, 丿, 丨, 丷, 冂, 口
淌	氵, 尚	氵, ⺌, 冂, 口	⺀, ㇀, 丨, 丷, 冂, 口
趟	走, 尚	走, ⺌, 冂, 口	一, 丨, 一, 龰, 丨, 丷, 冂, 口
烫	汤, 火	氵, ㇎, No glyph availabl, 火	⺀, ㇀, ㇎, ㇒, 丿, 丶, 冫
掏	扌, 匋	扌, 勹, 缶	亅, 二, ㇆, ㇒, 一, 一, 丨, ㇒, 丨, 凵
涛	氵, 寿	氵, 一, 二, 丨, 寸	⺀, ㇀, 一, 二, 丨, 𠂇, 亅, 丶
滔	氵, 舀	氵, 爫, 臼	⺀, ㇀, 爫, 臼
绦	纟, 条	纟, 夂, 十, 小	㇛, 一, ㇇, ㇏, ㇒, 一, 丨, 亅, 八
萄	艹, 匋	艹, 勹, 缶	艹, ㇆, ㇒, 一, 一, 丨, ㇒, 丨, 凵
桃	木, 兆	木, 儿, 冫, No glyph availabl	一, 丨, 八, 丿, 乚, 丶, ㇀, 冫
逃	辶, 兆	辶, 儿, 冫, No glyph availabl	丶, ㇆, ㇝, 丿, 乚, 丶, ㇀, 冫
淘	氵, 匋	氵, 勹, 缶	⺀, ㇀, ㇆, ㇒, 一, 一, 丨, ㇒, 丨, 凵
陶	阝, 匋	阝, 勹, 缶	丨, ㇌, ㇆, ㇒, 一, 一, 丨, ㇒, 丨, 凵
讨	讠, 寸	讠, 寸	㇊, 丶, 𠂇, 亅, 丶
套	大, 镸	大, 镸	人, 一, 彐, 一, ㇛, 丶
特	牛, 寺	牛, 土, 寸	二, 丨, ㇒, 一, 丨, 一, 𠂇, 亅, 丶
藤	艹, 滕	艹, 月, 二, 丨, 丷, 八, 氺	艹, 冂, 二, 二, 丨, 丷, 八, 亅, 丶, ㇀, 冫
腾	月, No glyph available	月, 二, 丨, 丷, 八, 马	冂, 二, 二, 丨, 丷, 八, ㇕, ㇉, 一
疼	疒, 冬	疒, 夂, ⺀	一, 丶, 厂, 丶, ㇇, ㇏, ㇒, ⺀
誊	龹, 言	二, 丨, 丷, 八, 言	二, 丨, 丷, 八, 一, 丶, 二, 口
梯	木, 弟	木, 丷, 弓, 丨, ㇒	一, 丨, 八, 丷, 匚, ㇉, 丨, ㇒
剔	易, 刂	日, 勹, No glyph availabl, 刂	口, 一, ㇆, ㇒, ㇒, 亅, 丨
踢	⻊, 易	⻊, 日, 勹, No glyph availabl	口, 丨, 一, 丨, 一, 口, 一, ㇆, ㇒, ㇒
锑	钅, 弟	钅, 丷, 弓, 丨, ㇒	丿, 一, 乚, 二, 丷, 匚, ㇉, 丨, ㇒
提	扌, 是	扌, 日, 一, 龰	亅, 二, 口, 一, 一, 龰
题	是, 页	日, 一, 龰, 页	口, 一, 一, 龰, 一, 丿, 冂, 人
蹄	⻊, 帝	⻊, 亠, 丷, 冖, 巾	口, 丨, 一, 丨, 一, 一, 丶, 丷, 冖, 冂, 丨
啼	口, 帝	口, 亠, 丷, 冖, 巾	口, 一, 丶, 丷, 冖, 冂, 丨
体	亻, 本	亻, 木, 一	㇒, 丨, 一, 丨, 八, 一
替	㚘, 日	㚘, 日	㚘, 口, 一
嚏	口, 疐	口, 十, 冖, 田, 疋	口, 一, 丨, 冖, 冂, 一, 丨, 一, ㇖, 龰
惕	忄, 易	忄, 日, 勹, No glyph availabl	丨, 八, 口, 一, ㇆, ㇒, ㇒
涕	氵, 弟	氵, 丷, 弓, 丨, ㇒	⺀, ㇀, 丷, 匚, ㇉, 丨, ㇒
剃	弟, 刂	丷, 弓, 丨, ㇒, 刂	丷, 匚, ㇉, 丨, ㇒, 亅, 丨
屉	尸, 世	尸, ㇗, 廿	丨, 匚, ㇗, 卄, 一
天	一, 大	一, 大	一, 人, 一
添	氵, 忝	氵, 一, 大, 丨, ㇒, No glyph availabl	⺀, ㇀, 一, 人, 一, 丨, ㇒, ㇏
填	土, 真	土, 十, 目, 一, 八	一, 丨, 一, 一, 丨, 口, 二, 一, 八
田	冂, 土	田	冂, 一, 丨, 一
甜	舌, 甘	舌, 甘	㇒, 一, 丨, 口, 艹, 二
恬	忄, 舌	忄, 舌	丨, 八, ㇒, 一, 丨, 口
舔	舌, 忝	舌, 一, 大, 丨, ㇒, No glyph availabl	㇒, 一, 丨, 口, 一, 人, 一, 丨, ㇒, ㇏
腆	月, 典	月, No glyph availabl, 二, 凵, 八	冂, 二, 丨, 二, 凵, 八
挑	扌, 兆	扌, 儿, 冫, No glyph availabl	亅, 二, 丿, 乚, 丶, ㇀, 冫
条	夂, 朩	夂, 十, 小	㇇, ㇏, ㇒, 一, 丨, 亅, 八
迢	辶, 召	辶, 刀, 口	丶, ㇆, ㇝, ㇆, 丿, 口
眺	目, 兆	目, 儿, 冫, No glyph availabl	口, 二, 丿, 乚, 丶, ㇀, 冫
跳	⻊, 兆	⻊, 儿, 冫, No glyph availabl	口, 丨, 一, 丨, 一, 丿, 乚, 丶, ㇀, 冫
贴	贝, 占	贝, ⺊, 口	冂, 人, 丨, 一, 口
铁	钅, 失	钅, 人, 二, ㇒	丿, 一, 乚, 二, 人, 二, ㇒
帖	巾, 占	巾, ⺊, 口	冂, 丨, 丨, 一, 口
厅	厂, 丁	厂, 一, 亅	厂, 一, 亅
听	口, 斤	口, 斤	口, 丿, ㇒, 一, 丨
烃	火, No glyph available	火, 龴, 工	丿, 丶, 冫, 龴, 一, 丨, 一
汀	氵, 丁	氵, 一, 亅	⺀, ㇀, 一, 亅
廷	廴, 壬	廴, ㇒, 士	㇋, ㇏, ㇒, 一, 丨, 一
停	亻, 亭	亻, 亠, 口, 冖, 一, 亅	㇒, 丨, 一, 丶, 口, 冖, 一, 亅
亭	No glyph available, 丁	亠, 口, 冖, 一, 亅	一, 丶, 口, 冖, 一, 亅
庭	广, 廷	广, 廴, ㇒, 士	厂, 丶, ㇋, ㇏, ㇒, 一, 丨, 一
艇	舟, 廷	舟, 廴, ㇒, 士	冂, 丶, ⺀, 一, ㇋, ㇏, ㇒, 一, 丨, 一
通	辶, 甬	辶, 龴, 用	丶, ㇆, ㇝, 龴, 冂, 二, 丨
桐	木, 同	木, 冂, 一, 口	一, 丨, 八, 冂, 一, 口
酮	酉, 同	酉, 冂, 一, 口	一, 丿, 乚, 口, 一, 冂, 一, 口
瞳	目, 童	目, 立, 里	口, 二, 一, 丶, 丷, 一, 冂, 一, 丨, 一, 一, 丨, 一
同	冂, 𠮛	冂, 一, 口	冂, 一, 口
铜	钅, 同	钅, 冂, 一, 口	丿, 一, 乚, 二, 冂, 一, 口
彤	丹, 彡	冂, 亠, 彡	冂, 一, 丶, 彡
童	立, 里	立, 里	一, 丶, 丷, 一, 冂, 一, 丨, 一, 一, 丨, 一
桶	木, 甬	木, 龴, 用	一, 丨, 八, 龴, 冂, 二, 丨
捅	扌, 甬	扌, 龴, 用	亅, 二, 龴, 冂, 二, 丨
筒	⺮, 同	⺮, 冂, 一, 口	⺮, 冂, 一, 口
统	纟, 充	纟, 亠, 厶, 儿	㇛, 一, 一, 丶, ㇛, 丶, 丿, 乚
痛	疒, 甬	疒, 龴, 用	一, 丶, 厂, 丶, 龴, 冂, 二, 丨
偷	亻, 俞	亻, 人, 一, 月, 刂	㇒, 丨, 人, 一, 冂, 二, 亅, 丨
投	扌, 殳	扌, 殳	亅, 二, 丿, ㇠, ㇇, ㇏
头	大, ⺀	大, ⺀	人, 一, ⺀
透	辶, 秀	辶, 禾, ㇎, 丿	丶, ㇆, ㇝, ㇒, 一, 丨, 八, ㇎, 丿
凸	丄	凸	凸
秃	禾, 几	禾, 几	㇒, 一, 丨, 八, 丿, ㇠
突	穴, 犬	穴, 犬	冖, 丶, 八, 人, 一, 丶
图	囗, 冬	囗, 夂, ⺀	冂, 一, ㇇, ㇏, ㇒, ⺀
徒	彳, 走	彳, 走	㇒, 丨, 一, 丨, 一, 龰
途	辶, 余	辶, 人, 干, 小	丶, ㇆, ㇝, 人, 一, 一, 丨, 亅, 八
涂	氵, 余	氵, 人, 干, 小	⺀, ㇀, 人, 一, 一, 丨, 亅, 八
屠	尸, 者	尸, 耂, 日	丨, 匚, 耂, 口, 一
土	十, 一	土	一, 丨, 一
吐	口, 土	口, 土	口, 一, 丨, 一
兔	免, 丶	⺈, 口, 丨, 乚, 丶	⺈, 口, 丨, 乚, 丶
湍	氵, 耑	氵, 山, 而	⺀, ㇀, 丨, 凵, 一, 丿, 冂, 丨
团	囗, 才	囗, 𠂇, ㇒	冂, 一, 𠂇, ㇒
推	扌, 隹	扌, 隹	亅, 二, ㇒, 丨, 一, 二, 丨, 一, 丶
颓	秃, 页	禾, 几, 页	㇒, 一, 丨, 八, 丿, ㇠, 一, 丿, 冂, 人
腿	月, 退	月, 辶, 艮	冂, 二, 丶, ㇆, ㇝, 丨, ㇕, 二, 乚, 冫
蜕	虫, 兑	虫, 丷, 口, 儿	口, 丨, 𠂉, 丷, 口, 丿, 乚
褪	衤, 退	衤, 辶, 艮	一, 一, 丨, 一, 丶, 戈, 丨, 冫, 丶, ㇆, ㇝, 丨, ㇕, 二, 乚, 冫
退	辶, 艮	辶, 艮	丶, ㇆, ㇝, 丨, ㇕, 二, 乚, 冫
吞	天, 口	一, 大, 口	一, 人, 一, 口
屯	十, 𡳾	十, 屮, 乚	一, 丨, 丨, 凵, 乚
臀	殿, 月	尸, 艹, 一, 八, 殳, 月	丨, 匚, 艹, 一, 八, 丿, ㇠, ㇇, ㇏, 冂, 二
拖	扌, 㐌	扌, 丿, 一, 乚, ㇆, 丨	亅, 二, 丿, 一, 乚, ㇆, 丨
托	扌, 乇	扌, ㇒, 乚, 一	亅, 二, ㇒, 乚, 一
脱	月, 兑	月, 丷, 口, 儿	冂, 二, 丷, 口, 丿, 乚
鸵	鸟, 它	鸟, 宀, 匕	㇆, ㇉, 丶, 丶, 一, 冖, 丶, 乚, ㇒
陀	阝, 它	阝, 宀, 匕	丨, ㇌, 冖, 丶, 乚, ㇒
驮	马, 大	马, 大	㇕, ㇉, 一, 人, 一
驼	马, 它	马, 宀, 匕	㇕, ㇉, 一, 冖, 丶, 乚, ㇒
椭	木, 陏	木, 阝, 𠂇, 月	一, 丨, 八, 丨, ㇌, 𠂇, 冂, 二
妥	爫, 女	爫, 女	爫, ㇛, 一, 丿
拓	扌, 石	扌, 石	亅, 二, 一, 丿, 口
唾	口, 垂	口, ㇒, 十, 士, 艹	口, ㇒, 一, 丨, 一, 丨, 一, 艹
挖	扌, 穵	扌, 穴, ㇠	亅, 二, 冖, 丶, 八, ㇠
哇	口, 圭	口, 圭	口, 圭
蛙	虫, 圭	虫, 圭	口, 丨, 𠂉, 圭
洼	氵, 圭	氵, 圭	⺀, ㇀, 圭
娃	女, 圭	女, 圭	㇛, 一, 丿, 圭
瓦	No glyph available, 丶	瓦	匸, ㇈, 丶
袜	衤, 末	衤, 木, 一	一, 一, 丨, 一, 丶, 戈, 丨, 冫, 一, 丨, 八, 一
歪	不, 正	一, 丿, 卜, 一, 止	一, 丿, 丨, 丶, 一, 丨, 一, 丨, 一
外	夕, 卜	夕, 卜	夕, 丨, 丶
豌	豆, 宛	豆, 宀, 夕, 乚, ㇆	一, 口, 丷, 一, 冖, 丶, 夕, 乚, ㇆
弯	亦, 弓	亠, 丨, 亅, 八, 弓	一, 丶, 丨, 亅, 八, 匚, ㇉
湾	氵, 弯	氵, 亠, 丨, 亅, 八, 弓	⺀, ㇀, 一, 丶, 丨, 亅, 八, 匚, ㇉
玩	王, 元	王, 二, 儿	一, 一, 丨, 一, 二, 丿, 乚
顽	元, 页	二, 儿, 页	二, 丿, 乚, 一, 丿, 冂, 人
丸	九, 丶	丿, ㇈, 丶	丿, ㇈, 丶
烷	火, 完	火, 宀, 二, 儿	丿, 丶, 冫, 冖, 丶, 二, 丿, 乚
完	宀, 元	宀, 二, 儿	冖, 丶, 二, 丿, 乚
碗	石, 宛	石, 宀, 夕, 乚, ㇆	一, 丿, 口, 冖, 丶, 夕, 乚, ㇆
挽	扌, 免	扌, ⺈, 口, 丨, 乚	亅, 二, ⺈, 口, 丨, 乚
晚	日, 免	日, ⺈, 口, 丨, 乚	口, 一, ⺈, 口, 丨, 乚
皖	白, 完	白, 宀, 二, 儿	口, 一, ㇒, 冖, 丶, 二, 丿, 乚
惋	忄, 宛	忄, 宀, 夕, 乚, ㇆	丨, 八, 冖, 丶, 夕, 乚, ㇆
宛	宀, 夗	宀, 夕, 乚, ㇆	冖, 丶, 夕, 乚, ㇆
婉	女, 宛	女, 宀, 夕, 乚, ㇆	㇛, 一, 丿, 冖, 丶, 夕, 乚, ㇆
万	一, No glyph available	一, 丿, ㇆	一, 丿, ㇆
腕	月, 宛	月, 宀, 夕, 乚, ㇆	冂, 二, 冖, 丶, 夕, 乚, ㇆
汪	氵, 王	氵, 王	⺀, ㇀, 一, 一, 丨, 一
王	一, 土	王	一, 一, 丨, 一
亡	匸, 丶	匸, 丶	匸, 丶
枉	木, 王	木, 王	一, 丨, 八, 一, 一, 丨, 一
网	冂, 爻	网	冂, 爻
往	彳, 主	彳, 王, 丶	㇒, 丨, 一, 一, 丨, 一, 丶
旺	日, 王	日, 王	口, 一, 一, 一, 丨, 一
望	肓, 王	匸, 丶, 月, 王	匸, 丶, 冂, 二, 一, 一, 丨, 一
忘	亡, 心	匸, 丶, 心	匸, 丶, 𠁼, ㇃
妄	亡, 女	匸, 丶, 女	匸, 丶, ㇛, 一, 丿
威	戌, 女	厂, 戈, 一, 女	厂, 戈, 一, ㇛, 一, 丿
巍	山, 魏	山, 禾, 女, 鬼	丨, 凵, ㇒, 一, 丨, 八, ㇛, 一, 丿, 冂, 二, 丨, 丶, 乚, ㇛, 丶
微	彳, No glyph available	彳, 山, ⺙, 一, 几	㇒, 丨, 丨, 凵, 丿, 一, 乂, 一, 丿, ㇠
危	⺈, 厄	⺈, 厂, 乚, ㇆	⺈, 厂, 乚, ㇆
韦	No glyph available, 丨	韦	一, 二, ㇆, 丨
违	辶, 韦	辶, 韦	丶, ㇆, ㇝, 一, 二, ㇆, 丨
桅	木, 危	木, ⺈, 厂, 乚, ㇆	一, 丨, 八, ⺈, 厂, 乚, ㇆
围	囗, 韦	囗, 韦	冂, 一, 一, 二, ㇆, 丨
唯	口, 隹	口, 隹	口, ㇒, 丨, 一, 二, 丨, 一, 丶
惟	忄, 隹	忄, 隹	丨, 八, ㇒, 丨, 一, 二, 丨, 一, 丶
为	力, ⺀	力, ⺀	㇆, 丿, ⺀
潍	氵, 维	氵, 纟, 隹	⺀, ㇀, ㇛, 一, ㇒, 丨, 一, 二, 丨, 一, 丶
维	纟, 隹	纟, 隹	㇛, 一, ㇒, 丨, 一, 二, 丨, 一, 丶
苇	艹, 韦	艹, 韦	艹, 一, 二, ㇆, 丨
萎	艹, 委	艹, 禾, 女	艹, ㇒, 一, 丨, 八, ㇛, 一, 丿
委	禾, 女	禾, 女	㇒, 一, 丨, 八, ㇛, 一, 丿
伟	亻, 韦	亻, 韦	㇒, 丨, 一, 二, ㇆, 丨
伪	亻, 为	亻, 力, ⺀	㇒, 丨, ㇆, 丿, ⺀
尾	尸, 毛	尸, 毛	丨, 匚, ㇒, 二, 乚
纬	纟, 韦	纟, 韦	㇛, 一, 一, 二, ㇆, 丨
未	木, 一	木, 一	一, 丨, 八, 一
蔚	艹, 尉	艹, 尸, 示, 寸	艹, 丨, 匚, 二, 亅, 八, 𠂇, 亅, 丶
味	口, 未	口, 木, 一	口, 一, 丨, 八, 一
畏	田, No glyph available	田, 一, 乚, No glyph availabl	冂, 一, 丨, 一, 一, 乚, 冫
胃	田, 月	田, 月	冂, 一, 丨, 一, 冂, 二
喂	口, 畏	口, 田, 一, 乚, No glyph availabl	口, 冂, 一, 丨, 一, 一, 乚, 冫
魏	委, 鬼	禾, 女, 鬼	㇒, 一, 丨, 八, ㇛, 一, 丿, 冂, 二, 丨, 丶, 乚, ㇛, 丶
位	亻, 立	亻, 立	㇒, 丨, 一, 丶, 丷, 一
渭	氵, 胃	氵, 田, 月	⺀, ㇀, 冂, 一, 丨, 一, 冂, 二
谓	讠, 胃	讠, 田, 月	㇊, 丶, 冂, 一, 丨, 一, 冂, 二
尉	No glyph available, 寸	尸, 示, 寸	丨, 匚, 二, 亅, 八, 𠂇, 亅, 丶
慰	尉, 心	尸, 示, 寸, 心	丨, 匚, 二, 亅, 八, 𠂇, 亅, 丶, 𠁼, ㇃
卫	No glyph available, 一	㇆, 丨, 一	㇆, 丨, 一
瘟	疒, 昷	疒, 日, 皿	一, 丶, 厂, 丶, 口, 一, 冂, 丨, 一
温	氵, 昷	氵, 日, 皿	⺀, ㇀, 口, 一, 冂, 丨, 一
蚊	虫, 文	虫, 文	口, 丨, 𠂉, 一, 丶, 乂
文	亠, 乂	文	一, 丶, 乂
闻	门, 耳	门, 耳	丶, 丨, ㇆, 二, 丨, 二
纹	纟, 文	纟, 文	㇛, 一, 一, 丶, 乂
吻	口, 勿	口, 勹, No glyph availabl	口, ㇆, ㇒, ㇒
稳	禾, 急	禾, ⺈, 彐, 心	㇒, 一, 丨, 八, ⺈, ㇕, 二, 𠁼, ㇃
紊	文, 糸	文, 糸	一, 丶, 乂, ㇛, 丶, 亅, 八
问	门, 口	门, 口	丶, 丨, ㇆, 口
嗡	口, 翁	口, 八, 厶, 羽	口, 八, ㇛, 丶, 羽
翁	公, 羽	八, 厶, 羽	八, ㇛, 丶, 羽
瓮	公, 瓦	八, 厶, 瓦	八, ㇛, 丶, 匸, ㇈, 丶
挝	扌, 过	扌, 辶, 寸	亅, 二, 丶, ㇆, ㇝, 𠂇, 亅, 丶
蜗	虫, 呙	虫, 口, 人, 冂	口, 丨, 𠂉, 口, 人, 冂
涡	氵, 呙	氵, 口, 人, 冂	⺀, ㇀, 口, 人, 冂
窝	穴, 呙	穴, 口, 人, 冂	冖, 丶, 八, 口, 人, 冂
我	手, 戈	手, 戈	㇒, 亅, 二, 戈
斡	龺, No glyph available	十, 日, 十, 人, 斗	一, 丨, 口, 一, 一, 丨, 人, 一, 丨, ⺀
卧	臣, 卜	臣, 卜	一, ㇗, 丨, 匚, 丨, 丶
握	扌, 屋	扌, 尸, 至	亅, 二, 丨, 匚, 一, ㇛, 丶, 一, 丨, 一
沃	氵, 夭	氵, ㇒, 大	⺀, ㇀, ㇒, 人, 一
巫	工, 从	工, 从	一, 丨, 一, 从
呜	口, 乌	口, ㇆, ㇉, 丶, 一	口, ㇆, ㇉, 丶, 一
钨	钅, 乌	钅, ㇆, ㇉, 丶, 一	丿, 一, 乚, 二, ㇆, ㇉, 丶, 一
乌	No glyph available, 一	㇆, ㇉, 丶, 一	㇆, ㇉, 丶, 一
污	氵, 亏	氵, 二, ㇉	⺀, ㇀, 二, ㇉
诬	讠, 巫	讠, 工, 从	㇊, 丶, 一, 丨, 一, 从
屋	尸, 至	尸, 至	丨, 匚, 一, ㇛, 丶, 一, 丨, 一
无	一, 尢	无	一, 𠂇, 乚
芜	艹, 无	艹, 无	艹, 一, 𠂇, 乚
梧	木, 吾	木, 一, 力, 一, 口	一, 丨, 八, 一, ㇆, 丿, 一, 口
吾	五, 口	一, 力, 一, 口	一, ㇆, 丿, 一, 口
吴	口, 天	口, 一, 大	口, 一, 人, 一
毋	No glyph available, 𠂇	毋	㇗, ㇆, 𠂇
武	No glyph available, 止	一, 弋, 止	一, 弋, 丨, 一, 丨, 一
五	一, No glyph available	一, 力, 一	一, ㇆, 丿, 一
捂	扌, 吾	扌, 一, 力, 一, 口	亅, 二, 一, ㇆, 丿, 一, 口
午	干, ㇒	干, ㇒	一, 一, 丨, ㇒
舞	No glyph available, 舛	No glyph availabl, 舛	𠂉, 卌, 一, 夕, 一, 丨, ㇗, 丨
伍	亻, 五	亻, 一, 力, 一	㇒, 丨, 一, ㇆, 丿, 一
侮	亻, 每	亻, 丿, 一, 母	㇒, 丨, 丿, 一, ㇗, ㇆, ⺀, 一
坞	土, 乌	土, ㇆, ㇉, 丶, 一	一, 丨, 一, ㇆, ㇉, 丶, 一
戊	厂, 戈	厂, 戈	厂, 戈
雾	雨, 务	雨, 夂, 力	一, 冂, 丨, 丶, ㇀, 冫, ㇇, ㇏, ㇒, ㇆, 丿
晤	日, 吾	日, 一, 力, 一, 口	口, 一, 一, ㇆, 丿, 一, 口
物	牛, 勿	牛, 勹, No glyph availabl	二, 丨, ㇒, ㇆, ㇒, ㇒
勿	勹, No glyph available	勹, No glyph availabl	㇆, ㇒, ㇒
务	夂, 力	夂, 力	㇇, ㇏, ㇒, ㇆, 丿
悟	忄, 吾	忄, 一, 力, 一, 口	丨, 八, 一, ㇆, 丿, 一, 口
误	讠, 吴	讠, 口, 一, 大	㇊, 丶, 口, 一, 人, 一
昔	龷, 日	艹, 一, 日	艹, 一, 口, 一
熙	巸, 灬	匚, No glyph availabl, 口, 巳, 灬	一, ㇗, 丨, 口, 丨, 匚, 乚, 灬
析	木, 斤	木, 斤	一, 丨, 八, 丿, ㇒, 一, 丨
西	兀, 囗	西	一, 丿, 乚, 冂, 一
硒	石, 西	石, 西	一, 丿, 口, 一, 丿, 乚, 冂, 一
矽	石, 夕	石, 夕	一, 丿, 口, 夕
晰	日, 析	日, 木, 斤	口, 一, 一, 丨, 八, 丿, ㇒, 一, 丨
嘻	口, 喜	口, 士, 口, 丷, 一, 口	口, 一, 丨, 一, 口, 丷, 一, 口
吸	口, 及	口, ㇎, 丿, ㇏	口, ㇎, 丿, ㇏
锡	钅, 易	钅, 日, 勹, No glyph availabl	丿, 一, 乚, 二, 口, 一, ㇆, ㇒, ㇒
牺	牛, 西	牛, 西	二, 丨, ㇒, 一, 丿, 乚, 冂, 一
稀	禾, 希	禾, 乂, 𠂇, 巾	㇒, 一, 丨, 八, 乂, 𠂇, 冂, 丨
息	自, 心	自, 心	口, 二, 丶, 𠁼, ㇃
希	乂, 布	乂, 𠂇, 巾	乂, 𠂇, 冂, 丨
悉	釆, 心	釆, 心	㇒, 一, 丨, 八, 丷, 𠁼, ㇃
膝	月, 桼	月, 木, 人, 氺	冂, 二, 一, 丨, 八, 人, 亅, 丶, ㇀, 冫
夕	勺	夕	夕
惜	忄, 昔	忄, 艹, 一, 日	丨, 八, 艹, 一, 口, 一
熄	火, 息	火, 自, 心	丿, 丶, 冫, 口, 二, 丶, 𠁼, ㇃
烯	火, 希	火, 乂, 𠂇, 巾	丿, 丶, 冫, 乂, 𠂇, 冂, 丨
溪	氵, 奚	氵, 爫, 幺, 大	⺀, ㇀, 爫, ㇛, 丶, 人, 一
汐	氵, 夕	氵, 夕	⺀, ㇀, 夕
犀	No glyph available, 牛	尸, 氺, 牛	丨, 匚, 亅, 丶, ㇀, 冫, 二, 丨, ㇒
檄	木, 敫	木, 白, 方, ⺙	一, 丨, 八, 口, 一, ㇒, 一, 丶, 丿, ㇆, 丿, 一, 乂
袭	龙, 衣	龙, 衣	𠂇, 丶, 乚, ㇒, 一, 丶, ㇒, ㇗, 冫
席	No glyph available, 巾	广, 廿, 巾	厂, 丶, 卄, 一, 冂, 丨
习	㇆, 亠	㇆, 亠	㇆, 一, 丶
媳	女, 息	女, 自, 心	㇛, 一, 丿, 口, 二, 丶, 𠁼, ㇃
喜	士, No glyph available	士, 口, 丷, 一, 口	一, 丨, 一, 口, 丷, 一, 口
铣	钅, 先	钅, ⺧, 儿	丿, 一, 乚, 二, ⺧, 丿, 乚
洗	氵, 先	氵, ⺧, 儿	⺀, ㇀, ⺧, 丿, 乚
系	㇒, 糸	㇒, 糸	㇒, ㇛, 丶, 亅, 八
隙	阝, No glyph available	阝, 小, 日, 小	丨, ㇌, 亅, 八, 口, 一, 亅, 八
戏	又, 戈	又, 戈	㇇, ㇏, 戈
细	纟, 田	纟, 田	㇛, 一, 冂, 一, 丨, 一
瞎	目, 害	目, 宀, 一, 二, 丨, 口	口, 二, 冖, 丶, 一, 二, 丨, 口
虾	虫, 下	虫, 一, 卜	口, 丨, 𠂉, 一, 丨, 丶
匣	匚, 甲	匚, 冂, 二, 丨	一, ㇗, 冂, 二, 丨
霞	雨, 叚	雨, 尸, 二, No glyph availabl, 又	一, 冂, 丨, 丶, ㇀, 冫, 丨, 匚, 二, 匚, ㇇, ㇏
辖	车, 害	车, 宀, 一, 二, 丨, 口	乚, 一, 一, 丨, 冖, 丶, 一, 二, 丨, 口
暇	日, 叚	日, 尸, 二, No glyph availabl, 又	口, 一, 丨, 匚, 二, 匚, ㇇, ㇏
峡	山, 夹	山, 人, 二, 丷	丨, 凵, 人, 二, 丷
侠	亻, 夹	亻, 人, 二, 丷	㇒, 丨, 人, 二, 丷
狭	犭, 夹	犭, 人, 二, 丷	㇁, ㇒, 人, 二, 丷
下	一, 卜	一, 卜	一, 丨, 丶
厦	厂, 夏	厂, 一, 自, 夂	厂, 一, 口, 二, 丶, ㇇, ㇏, ㇒
夏	𦣻, 夂	一, 自, 夂	一, 口, 二, 丶, ㇇, ㇏, ㇒
吓	口, 下	口, 一, 卜	口, 一, 丨, 丶
掀	扌, 欣	扌, 斤, 欠	亅, 二, 丿, ㇒, 一, 丨, ⺈, 人
锨	钅, 欣	钅, 斤, 欠	丿, 一, 乚, 二, 丿, ㇒, 一, 丨, ⺈, 人
先	⺧, 儿	⺧, 儿	⺧, 丿, 乚
仙	亻, 山	亻, 山	㇒, 丨, 丨, 凵
鲜	鱼, 羊	鱼, 羊	⺈, 冂, 一, 丨, 一, 一, 一, 二, 丨, 丷
纤	纟, 千	纟, ㇒, 十	㇛, 一, ㇒, 一, 丨
咸	戊, 𠮛	厂, 戈, 一, 口	厂, 戈, 一, 口
贤	No glyph available, 贝	丨, 丨, 又, 贝	丨, 丨, ㇇, ㇏, 冂, 人
衔	行, 钅	行, 钅	㇒, 丨, 二, 亅, 丿, 一, 乚, 二
舷	舟, 玄	舟, 玄	冂, 丶, ⺀, 一, 一, 丶, ㇛, 丶
闲	门, 木	门, 木	丶, 丨, ㇆, 一, 丨, 八
涎	氵, 延	氵, 廴, ㇒, 止	⺀, ㇀, ㇋, ㇏, ㇒, 丨, 一, 丨, 一
弦	弓, 玄	弓, 玄	匚, ㇉, 一, 丶, ㇛, 丶
嫌	女, 兼	女, 丷, 一, No glyph availabl, 八, ⺕	㇛, 一, 丿, 丷, 一, 丨, 八, 匚, 一
显	日, 业	日, No glyph availabl, 丷, 一	口, 一, 丨, 丷, 一
险	阝, 佥	阝, 人, 一, ⺍, 一	丨, ㇌, 人, 一, ⺍, 一
现	王, 见	王, 见	一, 一, 丨, 一, 冂, 丿, 乚
献	南, 犬	十, 冂, 丷, 干, 犬	一, 丨, 冂, 丷, 一, 一, 丨, 人, 一, 丶
县	且, 厶	月, 一, 厶	冂, 二, 一, ㇛, 丶
腺	月, 泉	月, 白, 水	冂, 二, 口, 一, ㇒, 亅, ㇇, 冫
馅	饣, 臽	饣, ⺈, 臼	⺈, 乚, ⺈, 臼
羡	羊, 次	羊, 冫, 欠	一, 二, 丨, 丷, 丶, ㇀, ⺈, 人
宪	宀, 先	宀, ⺧, 儿	冖, 丶, ⺧, 丿, 乚
陷	阝, 臽	阝, ⺈, 臼	丨, ㇌, ⺈, 臼
限	阝, 艮	阝, 艮	丨, ㇌, 丨, ㇕, 二, 乚, 冫
线	纟, 戋	纟, 戋	㇛, 一, 戋
相	木, 目	木, 目	一, 丨, 八, 口, 二
厢	厂, 相	厂, 木, 目	厂, 一, 丨, 八, 口, 二
镶	钅, 襄	钅, 衣, 吅, No glyph availabl, 二, 一	丿, 一, 乚, 二, 一, 丶, ㇒, ㇗, 冫, 吅, 丨, 二, 一
香	禾, 日	香	㇒, 一, 丨, 八, 口, 一
箱	⺮, 相	⺮, 木, 目	⺮, 一, 丨, 八, 口, 二
襄	衣, No glyph available	衣, 吅, No glyph availabl, 二, 一	一, 丶, ㇒, ㇗, 冫, 吅, 丨, 二, 一
湘	氵, 相	氵, 木, 目	⺀, ㇀, 一, 丨, 八, 口, 二
乡	No glyph available, 丿	No glyph availabl, 丿	㇛, 丿
翔	羊, 羽	羊, 羽	一, 二, 丨, 丷, 羽
祥	礻, 羊	礻, 羊	一, 一, 丨, 一, 丶, 戈, 丨, 丶, 一, 二, 丨, 丷
详	讠, 羊	讠, 羊	㇊, 丶, 一, 二, 丨, 丷
想	相, 心	木, 目, 心	一, 丨, 八, 口, 二, 𠁼, ㇃
响	口, 向	口, 宀, 口	口, 冖, 丶, 口
享	No glyph available, 子	亠, 口, 子	一, 丶, 口, ㇇, 亅, 一
项	工, 页	工, 页	一, 丨, 一, 一, 丿, 冂, 人
巷	共, 巳	艹, 一, 八, 巳	艹, 一, 八, 丨, 匚, 乚
橡	木, 象	木, ⺈, 口, 丨, 勹, No glyph availabl, No glyph availabl	一, 丨, 八, ⺈, 口, 丨, ㇆, ㇒, ㇒, 冫
像	亻, 象	亻, ⺈, 口, 丨, 勹, No glyph availabl, No glyph availabl	㇒, 丨, ⺈, 口, 丨, ㇆, ㇒, ㇒, 冫
向	宀, 口	宀, 口	冖, 丶, 口
象	⺈, No glyph available	⺈, 口, 丨, 勹, No glyph availabl, No glyph availabl	⺈, 口, 丨, ㇆, ㇒, ㇒, 冫
萧	艹, 肃	艹, ⺺, No glyph availabl, 小	艹, 匚, 一, 丨, 丨, 亅, 八
硝	石, 肖	石, ⺌, 月	一, 丿, 口, 丨, 丷, 冂, 二
霄	雨, 肖	雨, ⺌, 月	一, 冂, 丨, 丶, ㇀, 冫, 丨, 丷, 冂, 二
削	肖, 刂	⺌, 月, 刂	丨, 丷, 冂, 二, 亅, 丨
哮	口, 孝	口, 耂, 子	口, 耂, ㇇, 亅, 一
嚣	㗊, 页	㗊, 页	㗊, 一, 丿, 冂, 人
销	钅, 肖	钅, ⺌, 月	丿, 一, 乚, 二, 丨, 丷, 冂, 二
消	氵, 肖	氵, ⺌, 月	⺀, ㇀, 丨, 丷, 冂, 二
宵	宀, 肖	宀, ⺌, 月	冖, 丶, 丨, 丷, 冂, 二
淆	氵, 肴	氵, 乂, 𠂇, 月	⺀, ㇀, 乂, 𠂇, 冂, 二
晓	日, 尧	日, No glyph availabl, 一, 儿	口, 一, ㇂, 一, ㇒, 一, 丿, 乚
小	亅, 八	小	亅, 八
孝	耂, 子	耂, 子	耂, ㇇, 亅, 一
校	木, 交	木, 亠, 八, 乂	一, 丨, 八, 一, 丶, 八, 乂
肖	⺌, 月	⺌, 月	丨, 丷, 冂, 二
啸	口, 肃	口, ⺺, No glyph availabl, 小	口, 匚, 一, 丨, 丨, 亅, 八
笑	⺮, 夭	⺮, ㇒, 大	⺮, ㇒, 人, 一
效	交, ⺙	亠, 八, 乂, ⺙	一, 丶, 八, 乂, 丿, 一, 乂
楔	木, 契	木, 一, 二, 丨, 刀, 大	一, 丨, 八, 一, 二, 丨, ㇆, 丿, 人, 一
些	此, 二	止, 匕, 二	丨, 一, 丨, 一, 乚, ㇒, 二
歇	曷, 欠	曰, 勹, 人, ㇗, 欠	口, 一, ㇆, ㇒, 人, ㇗, ⺈, 人
蝎	虫, 曷	虫, 曰, 勹, 人, ㇗	口, 丨, 𠂉, 口, 一, ㇆, ㇒, 人, ㇗
鞋	革, 圭	革, 圭	卄, 一, 口, 丨, 一, 丨, 圭
协	十, 办	十, 力, 八	一, 丨, ㇆, 丿, 八
挟	扌, 夹	扌, 人, 二, 丷	亅, 二, 人, 二, 丷
携	扌, 隽	扌, 隹, ㇎, 丿	亅, 二, ㇒, 丨, 一, 二, 丨, 一, 丶, ㇎, 丿
邪	牙, 阝	牙, 阝	一, 丨, ㇜, 亅, 丿, 丨, ㇌
斜	余, 斗	人, 干, 小, 斗	人, 一, 一, 丨, 亅, 八, 一, 丨, ⺀
胁	月, 办	月, 力, 八	冂, 二, ㇆, 丿, 八
谐	讠, 皆	讠, 比, 白	㇊, 丶, 比, 口, 一, ㇒
写	冖, 与	冖, No glyph availabl, 一	冖, 己, 一
械	木, 戒	木, 戈, 艹	一, 丨, 八, 戈, 艹
卸	𦈢, 卩	干, ㇒, 止, 卩	一, 一, 丨, ㇒, 丨, 一, 丨, 一, 丨, ㇆
蟹	解, 虫	角, 刀, 牛, 虫	⺈, 冂, 二, 丨, ㇆, 丿, 二, 丨, ㇒, 口, 丨, 𠂉
懈	忄, 解	忄, 角, 刀, 牛	丨, 八, ⺈, 冂, 二, 丨, ㇆, 丿, 二, 丨, ㇒
泄	氵, 世	氵, ㇗, 廿	⺀, ㇀, ㇗, 卄, 一
泻	氵, 写	氵, 冖, No glyph availabl, 一	⺀, ㇀, 冖, 己, 一
谢	讠, 射	讠, 身, 寸	㇊, 丶, 𠂎, 丶, 二, 丿, 𠂇, 亅, 丶
屑	尸, 肖	尸, ⺌, 月	丨, 匚, 丨, 丷, 冂, 二
薪	艹, 新	艹, 立, 十, 小, 斤	艹, 一, 丶, 丷, 一, 一, 丨, 亅, 八, 丿, ㇒, 一, 丨
芯	艹, 心	艹, 心	艹, 𠁼, ㇃
锌	钅, 辛	钅, 辛	丿, 一, 乚, 二, 一, 丶, 丷, 一, 一, 丨
欣	斤, 欠	斤, 欠	丿, ㇒, 一, 丨, ⺈, 人
辛	立, 十	辛	一, 丶, 丷, 一, 一, 丨
新	亲, 斤	立, 十, 小, 斤	一, 丶, 丷, 一, 一, 丨, 亅, 八, 丿, ㇒, 一, 丨
忻	忄, 斤	忄, 斤	丨, 八, 丿, ㇒, 一, 丨
心	𠁼, ㇃	心	𠁼, ㇃
信	亻, 言	亻, 言	㇒, 丨, 一, 丶, 二, 口
衅	血, 半	血, 二, 丨, 丷	冂, 丨, 一, 丶, 二, 丨, 丷
星	日, 生	日, 生	口, 一, 龶, ㇒
腥	月, 星	月, 日, 生	冂, 二, 口, 一, 龶, ㇒
猩	犭, 星	犭, 日, 生	㇁, ㇒, 口, 一, 龶, ㇒
惺	忄, 星	忄, 日, 生	丨, 八, 口, 一, 龶, ㇒
兴	No glyph available, 八	⺍, 一, 八	⺍, 一, 八
刑	开, 刂	一, 廾, 刂	一, 廾, 亅, 丨
型	刑, 土	一, 廾, 刂, 土	一, 廾, 亅, 丨, 一, 丨, 一
形	开, 彡	一, 廾, 彡	一, 廾, 彡
邢	开, 阝	一, 廾, 阝	一, 廾, 丨, ㇌
行	彳, 亍	行	㇒, 丨, 二, 亅
醒	酉, 星	酉, 日, 生	一, 丿, 乚, 口, 一, 口, 一, 龶, ㇒
幸	土, 𢆉	土, 丷, 干	一, 丨, 一, 丷, 一, 一, 丨
杏	木, 口	木, 口	一, 丨, 八, 口
性	忄, 生	忄, 生	丨, 八, 龶, ㇒
姓	女, 生	女, 生	㇛, 一, 丿, 龶, ㇒
兄	口, 儿	口, 儿	口, 丿, 乚
凶	凵, 乂	凵, 乂	凵, 乂
胸	月, 匈	月, 勹, 凵, 乂	冂, 二, ㇆, ㇒, 凵, 乂
匈	勹, 凶	勹, 凵, 乂	㇆, ㇒, 凵, 乂
汹	氵, 凶	氵, 凵, 乂	⺀, ㇀, 凵, 乂
雄	厷, 隹	𠂇, 厶, 隹	𠂇, ㇛, 丶, ㇒, 丨, 一, 二, 丨, 一, 丶
熊	能, 灬	厶, 月, No glyph availabl, 灬	㇛, 丶, 冂, 二, 匕, 灬
休	亻, 木	亻, 木	㇒, 丨, 一, 丨, 八
修	No glyph available, No glyph available	亻, 丨, ⺙, 彡	㇒, 丨, 丨, 丿, 一, 乂, 彡
羞	羊, 丑	羊, 刀, 二	一, 二, 丨, 丷, ㇆, 丿, 二
朽	木, 丂	木, 一, ㇉	一, 丨, 八, 一, ㇉
嗅	口, 臭	口, 自, 犬	口, 口, 二, 丶, 人, 一, 丶
锈	钅, 秀	钅, 禾, ㇎, 丿	丿, 一, 乚, 二, ㇒, 一, 丨, 八, ㇎, 丿
秀	禾, 乃	禾, ㇎, 丿	㇒, 一, 丨, 八, ㇎, 丿
袖	衤, 由	衤, 二, 丨, 凵	一, 一, 丨, 一, 丶, 戈, 丨, 冫, 二, 丨, 凵
绣	纟, 秀	纟, 禾, ㇎, 丿	㇛, 一, ㇒, 一, 丨, 八, ㇎, 丿
墟	土, 虚	土, 虍, No glyph availabl, 丷, 一	一, 丨, 一, 丨, 一, 冖, 乚, 一, 丨, 丷, 一
戌	戊, 一	厂, 戈, 一	厂, 戈, 一
需	雨, 而	雨, 而	一, 冂, 丨, 丶, ㇀, 冫, 一, 丿, 冂, 丨
虚	虍, 业	虍, No glyph availabl, 丷, 一	丨, 一, 冖, 乚, 一, 丨, 丷, 一
嘘	口, 虚	口, 虍, No glyph availabl, 丷, 一	口, 丨, 一, 冖, 乚, 一, 丨, 丷, 一
须	彡, 页	彡, 页	彡, 一, 丿, 冂, 人
徐	彳, 余	彳, 人, 干, 小	㇒, 丨, 人, 一, 一, 丨, 亅, 八
许	讠, 午	讠, 干, ㇒	㇊, 丶, 一, 一, 丨, ㇒
蓄	艹, 畜	艹, 玄, 田	艹, 一, 丶, ㇛, 丶, 冂, 一, 丨, 一
酗	酉, 凶	酉, 凵, 乂	一, 丿, 乚, 口, 一, 凵, 乂
叙	余, 又	人, 干, 小, 又	人, 一, 一, 丨, 亅, 八, ㇇, ㇏
旭	九, 日	丿, ㇈, 日	丿, ㇈, 口, 一
序	广, 予	广, 龴, ㇖, 亅	厂, 丶, 龴, ㇖, 亅
畜	玄, 田	玄, 田	一, 丶, ㇛, 丶, 冂, 一, 丨, 一
恤	忄, 血	忄, 血	丨, 八, 冂, 丨, 一, 丶
絮	如, 糸	女, 口, 糸	㇛, 一, 丿, 口, ㇛, 丶, 亅, 八
婿	女, 胥	女, 疋, 月	㇛, 一, 丿, ㇖, 龰, 冂, 二
绪	纟, 者	纟, 耂, 日	㇛, 一, 耂, 口, 一
续	纟, 卖	纟, 十, ㇖, 大, ⺀	㇛, 一, 一, 丨, ㇖, 人, 一, ⺀
轩	车, 干	车, 干	乚, 一, 一, 丨, 一, 一, 丨
喧	口, 宣	口, 宀, 一, 日, 一	口, 冖, 丶, 一, 口, 一, 一
宣	宀, 亘	宀, 一, 日, 一	冖, 丶, 一, 口, 一, 一
悬	且, No glyph available	月, 一, 厶, 心	冂, 二, 一, ㇛, 丶, 𠁼, ㇃
旋	方, No glyph available	方, 丿, 一, 疋	一, 丶, 丿, ㇆, 丿, 一, ㇖, 龰
玄	亠, 幺	玄	一, 丶, ㇛, 丶
选	辶, 先	辶, ⺧, 儿	丶, ㇆, ㇝, ⺧, 丿, 乚
癣	疒, 鲜	疒, 鱼, 羊	一, 丶, 厂, 丶, ⺈, 冂, 一, 丨, 一, 一, 一, 二, 丨, 丷
眩	目, 玄	目, 玄	口, 二, 一, 丶, ㇛, 丶
绚	纟, 旬	纟, 勹, 日	㇛, 一, ㇆, ㇒, 口, 一
靴	革, 化	革, 亻, 匕	卄, 一, 口, 丨, 一, 丨, ㇒, 丨, 乚, ㇒
薛	艹, No glyph available	艹, 㠯, 丶, 辛	艹, 㠯, 丶, 一, 丶, 丷, 一, 一, 丨
学	No glyph available, 子	⺍, 冖, 子	⺍, 冖, ㇇, 亅, 一
穴	宀, 八	穴	冖, 丶, 八
雪	雨, 彐	雨, 彐	一, 冂, 丨, 丶, ㇀, 冫, ㇕, 二
血	皿, 丶	血	冂, 丨, 一, 丶
勋	员, 力	口, 贝, 力	口, 冂, 人, ㇆, 丿
熏	No glyph available, 灬	㇒, 十, 口, 丨, 丷, 土, 灬	㇒, 一, 丨, 口, 丨, 丷, 一, 丨, 一, 灬
循	彳, 盾	彳, ⺁, 十, 目	㇒, 丨, 丿, ㇒, 一, 丨, 口, 二
旬	勹, 日	勹, 日	㇆, ㇒, 口, 一
询	讠, 旬	讠, 勹, 日	㇊, 丶, ㇆, ㇒, 口, 一
寻	彐, 寸	彐, 寸	㇕, 二, 𠂇, 亅, 丶
驯	马, 川	马, 川	㇕, ㇉, 一, 川
巡	辶, 巛	辶, 巛	丶, ㇆, ㇝, 巛
殉	歹, 旬	歹, 勹, 日	一, 夕, ㇆, ㇒, 口, 一
汛	氵, 卂	氵, ㇠, 十	⺀, ㇀, ㇠, 一, 丨
训	讠, 川	讠, 川	㇊, 丶, 川
讯	讠, 卂	讠, ㇠, 十	㇊, 丶, ㇠, 一, 丨
逊	辶, 孙	辶, 子, 小	丶, ㇆, ㇝, ㇇, 亅, 一, 亅, 八
迅	辶, 卂	辶, ㇠, 十	丶, ㇆, ㇝, ㇠, 一, 丨
压	厂, 圡	厂, 土, 丶	厂, 一, 丨, 一, 丶
押	扌, 甲	扌, 冂, 二, 丨	亅, 二, 冂, 二, 丨
鸦	牙, 鸟	牙, 鸟	一, 丨, ㇜, 亅, 丿, ㇆, ㇉, 丶, 丶, 一
鸭	甲, 鸟	冂, 二, 丨, 鸟	冂, 二, 丨, ㇆, ㇉, 丶, 丶, 一
呀	口, 牙	口, 牙	口, 一, 丨, ㇜, 亅, 丿
丫	丷, 丨	丷, 丨	丷, 丨
芽	艹, 牙	艹, 牙	艹, 一, 丨, ㇜, 亅, 丿
牙	No glyph available, 丿	牙	一, 丨, ㇜, 亅, 丿
蚜	虫, 牙	虫, 牙	口, 丨, 𠂉, 一, 丨, ㇜, 亅, 丿
崖	山, 厓	山, 厂, 圭	丨, 凵, 厂, 圭
衙	行, 吾	行, 一, 力, 一, 口	㇒, 丨, 二, 亅, 一, ㇆, 丿, 一, 口
涯	氵, 厓	氵, 厂, 圭	⺀, ㇀, 厂, 圭
雅	牙, 隹	牙, 隹	一, 丨, ㇜, 亅, 丿, ㇒, 丨, 一, 二, 丨, 一, 丶
哑	口, 亚	口, 一, No glyph availabl, 丷, 一	口, 一, 丨, 丷, 一
亚	一, 业	一, No glyph availabl, 丷, 一	一, 丨, 丷, 一
讶	讠, 牙	讠, 牙	㇊, 丶, 一, 丨, ㇜, 亅, 丿
焉	正, No glyph available	一, 止, No glyph availabl, 灬	一, 丨, 一, 丨, 一, 己, 灬
咽	口, 因	口, 囗, 大	口, 冂, 一, 人, 一
阉	门, 奄	门, 大, 日, 丨, 乚	丶, 丨, ㇆, 人, 一, 口, 一, 丨, 乚
烟	火, 因	火, 囗, 大	丿, 丶, 冫, 冂, 一, 人, 一
淹	氵, 奄	氵, 大, 日, 丨, 乚	⺀, ㇀, 人, 一, 口, 一, 丨, 乚
盐	圤, 皿	土, 卜, 皿	一, 丨, 一, 丨, 丶, 冂, 丨, 一
严	亚, 厂	一, No glyph availabl, 丷, 一, 厂	一, 丨, 丷, 一, 厂
研	石, 开	石, 一, 廾	一, 丿, 口, 一, 廾
蜒	虫, 延	虫, 廴, ㇒, 止	口, 丨, 𠂉, ㇋, ㇏, ㇒, 丨, 一, 丨, 一
岩	山, 石	山, 石	丨, 凵, 一, 丿, 口
延	廴, No glyph available	廴, ㇒, 止	㇋, ㇏, ㇒, 丨, 一, 丨, 一
言	亠, No glyph available	言	一, 丶, 二, 口
颜	彦, 页	立, 厂, 彡, 页	一, 丶, 丷, 一, 厂, 彡, 一, 丿, 冂, 人
阎	门, 臽	门, ⺈, 臼	丶, 丨, ㇆, ⺈, 臼
炎	火	炎	炎
沿	氵, No glyph available	氵, 几, 口	⺀, ㇀, 丿, ㇠, 口
奄	大, 电	大, 日, 丨, 乚	人, 一, 口, 一, 丨, 乚
掩	扌, 奄	扌, 大, 日, 丨, 乚	亅, 二, 人, 一, 口, 一, 丨, 乚
眼	目, 艮	目, 艮	口, 二, 丨, ㇕, 二, 乚, 冫
衍	行, 氵	行, 氵	㇒, 丨, 二, 亅, ⺀, ㇀
演	氵, 寅	氵, 宀, 一, 二, 丨, 凵, 八	⺀, ㇀, 冖, 丶, 一, 二, 丨, 凵, 八
艳	丰, 色	一, 二, 丨, 色	一, 二, 丨, ⺈, 丨, 匚, 丨, 乚
堰	土, 匽	土, 匚, 日, 女	一, 丨, 一, 一, ㇗, 口, 一, ㇛, 一, 丿
燕	No glyph available, 灬	廿, 北, 口, 灬	卄, 一, 北, 口, 灬
厌	厂, 犬	厂, 犬	厂, 人, 一, 丶
砚	石, 见	石, 见	一, 丿, 口, 冂, 丿, 乚
雁	厂, 倠	厂, 亻, 隹	厂, ㇒, 丨, ㇒, 丨, 一, 二, 丨, 一, 丶
唁	口, 言	口, 言	口, 一, 丶, 二, 口
彦	产, 彡	立, 厂, 彡	一, 丶, 丷, 一, 厂, 彡
焰	火, 臽	火, ⺈, 臼	丿, 丶, 冫, ⺈, 臼
宴	宀, 妟	宀, 日, 女	冖, 丶, 口, 一, ㇛, 一, 丿
谚	讠, 彦	讠, 立, 厂, 彡	㇊, 丶, 一, 丶, 丷, 一, 厂, 彡
验	马, 佥	马, 人, 一, ⺍, 一	㇕, ㇉, 一, 人, 一, ⺍, 一
殃	歹, 央	歹, 大, 冂	一, 夕, 人, 一, 冂
央	大, 冂	大, 冂	人, 一, 冂
鸯	央, 鸟	大, 冂, 鸟	人, 一, 冂, ㇆, ㇉, 丶, 丶, 一
秧	禾, 央	禾, 大, 冂	㇒, 一, 丨, 八, 人, 一, 冂
杨	木, 𠃓	木, ㇎, No glyph availabl	一, 丨, 八, ㇎, ㇒
扬	扌, 𠃓	扌, ㇎, No glyph availabl	亅, 二, ㇎, ㇒
佯	亻, 羊	亻, 羊	㇒, 丨, 一, 二, 丨, 丷
疡	疒, 𠃓	疒, ㇎, No glyph availabl	一, 丶, 厂, 丶, ㇎, ㇒
羊	No glyph available, 丷	羊	一, 二, 丨, 丷
洋	氵, 羊	氵, 羊	⺀, ㇀, 一, 二, 丨, 丷
阳	阝, 日	阝, 日	丨, ㇌, 口, 一
氧	气, 羊	气, 羊	丿, 一, 一, ㇠, 一, 二, 丨, 丷
仰	亻, 卬	亻, ㇒, ㇗, 卩	㇒, 丨, ㇒, ㇗, 丨, ㇆
痒	疒, 羊	疒, 羊	一, 丶, 厂, 丶, 一, 二, 丨, 丷
养	No glyph available, No glyph available	羊, 八, No glyph availabl	一, 二, 丨, 丷, 八, 丨
样	木, 羊	木, 羊	一, 丨, 八, 一, 二, 丨, 丷
漾	氵, 羕	氵, 羊, ㇆, ㇇, No glyph availabl, 丶	⺀, ㇀, 一, 二, 丨, 丷, ㇆, ㇇, 冫, 丶
邀	辶, 敫	辶, 白, 方, ⺙	丶, ㇆, ㇝, 口, 一, ㇒, 一, 丶, 丿, ㇆, 丿, 一, 乂
腰	月, No glyph available	月, 西, 女	冂, 二, 一, 丿, 乚, 冂, 一, ㇛, 一, 丿
妖	女, 夭	女, ㇒, 大	㇛, 一, 丿, ㇒, 人, 一
瑶	王, No glyph available	王, 爫, 缶	一, 一, 丨, 一, 爫, 一, 一, 丨, ㇒, 丨, 凵
摇	扌, No glyph available	扌, 爫, 缶	亅, 二, 爫, 一, 一, 丨, ㇒, 丨, 凵
尧	No glyph available, 兀	No glyph availabl, 一, 儿	㇂, 一, ㇒, 一, 丿, 乚
遥	No glyph available, 爫	辶, 缶, 爫	丶, ㇆, ㇝, 一, 一, 丨, ㇒, 丨, 凵, 爫
窑	穴, 缶	穴, 缶	冖, 丶, 八, 一, 一, 丨, ㇒, 丨, 凵
谣	讠, No glyph available	讠, 爫, 缶	㇊, 丶, 爫, 一, 一, 丨, ㇒, 丨, 凵
姚	女, 兆	女, 儿, 冫, No glyph availabl	㇛, 一, 丿, 丿, 乚, 丶, ㇀, 冫
咬	口, 交	口, 亠, 八, 乂	口, 一, 丶, 八, 乂
舀	爫, 臼	爫, 臼	爫, 臼
药	艹, 约	艹, 纟, 勹, 丶	艹, ㇛, 一, ㇆, ㇒, 丶
要	覀, 女	覀, 女	覀, ㇛, 一, 丿
耀	光, 翟	⺌, 一, 儿, 羽, 隹	丨, 丷, 一, 丿, 乚, 羽, ㇒, 丨, 一, 二, 丨, 一, 丶
椰	木, 耶	木, 耳, 阝	一, 丨, 八, 二, 丨, 二, 丨, ㇌
噎	口, 壹	口, 士, 冖, 豆	口, 一, 丨, 一, 冖, 一, 口, 丷, 一
耶	耳, 阝	耳, 阝	二, 丨, 二, 丨, ㇌
爷	父, No glyph available	父, ㇆, 丨	八, 乂, ㇆, 丨
野	里, 予	里, 龴, ㇖, 亅	冂, 一, 丨, 一, 一, 丨, 一, 龴, ㇖, 亅
冶	冫, 台	冫, 厶, 口	丶, ㇀, ㇛, 丶, 口
也	乚, No glyph available	乚, ㇆, 丨	乚, ㇆, 丨
页	丆, 贝	页	一, 丿, 冂, 人
掖	扌, 夜	扌, 亠, 亻, 夂, 丶	亅, 二, 一, 丶, ㇒, 丨, ㇇, ㇏, ㇒, 丶
业	No glyph available, 一	No glyph availabl, 丷, 一	丨, 丷, 一
叶	口, 十	口, 十	口, 一, 丨
曳	㇂, 日, ㇒	曳	曳
腋	月, 夜	月, 亠, 亻, 夂, 丶	冂, 二, 一, 丶, ㇒, 丨, ㇇, ㇏, ㇒, 丶
夜	亠, No glyph available	亠, 亻, 夂, 丶	一, 丶, ㇒, 丨, ㇇, ㇏, ㇒, 丶
液	氵, 夜	氵, 亠, 亻, 夂, 丶	⺀, ㇀, 一, 丶, ㇒, 丨, ㇇, ㇏, ㇒, 丶
一	一	一	一
壹	士, No glyph available	士, 冖, 豆	一, 丨, 一, 冖, 一, 口, 丷, 一
医	匚, 矢	匚, 矢	一, ㇗, 丿, 一, 人, 一
揖	扌, 咠	扌, 口, 耳	亅, 二, 口, 二, 丨, 二
铱	钅, 衣	钅, 衣	丿, 一, 乚, 二, 一, 丶, ㇒, ㇗, 冫
依	亻, 衣	亻, 衣	㇒, 丨, 一, 丶, ㇒, ㇗, 冫
伊	亻, 尹	亻, ⺕, 丨	㇒, 丨, 匚, 一, 丨
衣	亠, 𧘇	衣	一, 丶, ㇒, ㇗, 冫
颐	𦣞, 页	匚, No glyph availabl, 口, 页	一, ㇗, 丨, 口, 一, 丿, 冂, 人
夷	大, 弓	大, 弓	人, 一, 匚, ㇉
遗	辶, 贵	辶, 口, 丨, 一, 贝	丶, ㇆, ㇝, 口, 丨, 一, 冂, 人
移	禾, 多	禾, 多	㇒, 一, 丨, 八, 多
仪	亻, 义	亻, 乂, 丶	㇒, 丨, 乂, 丶
胰	月, 夷	月, 大, 弓	冂, 二, 人, 一, 匚, ㇉
疑	𠤕, No glyph available	匕, 矢, 龴, 疋	乚, ㇒, 丿, 一, 人, 一, 龴, ㇖, 龰
沂	氵, 斤	氵, 斤	⺀, ㇀, 丿, ㇒, 一, 丨
宜	宀, 且	宀, 月, 一	冖, 丶, 冂, 二, 一
姨	女, 夷	女, 大, 弓	㇛, 一, 丿, 人, 一, 匚, ㇉
彝	彑, No glyph available	彑, 米, 糸, 艹	㇗, ㇕, 一, 一, 丨, 八, 丷, ㇛, 丶, 亅, 八, 艹
椅	木, 奇	木, 大, 一, 亅, 口	一, 丨, 八, 人, 一, 一, 亅, 口
蚁	虫, 义	虫, 乂, 丶	口, 丨, 𠂉, 乂, 丶
倚	亻, 奇	亻, 大, 一, 亅, 口	㇒, 丨, 人, 一, 一, 亅, 口
已	己	已	已
乙	㇠	乙	乙
矣	厶, 矢	厶, 矢	㇛, 丶, 丿, 一, 人, 一
以	No glyph available, 人	乚, 丶, 人	乚, 丶, 人
艺	艹, ㇠	艹, ㇠	艹, ㇠
抑	扌, 卬	扌, ㇒, ㇗, 卩	亅, 二, ㇒, ㇗, 丨, ㇆
易	日, 勿	日, 勹, No glyph availabl	口, 一, ㇆, ㇒, ㇒
邑	口, 巴	邑	口, 丨, 匚, 丨, 乚
屹	山, 乞	山, 丿, 一, ㇠	丨, 凵, 丿, 一, ㇠
亿	亻, ㇠	亻, ㇠	㇒, 丨, ㇠
役	彳, 殳	彳, 殳	㇒, 丨, 丿, ㇠, ㇇, ㇏
臆	月, 意	月, 音, 心	冂, 二, 一, 丶, 丷, 一, 口, 一, 𠁼, ㇃
逸	辶, 兔	辶, ⺈, 口, 丨, 乚, 丶	丶, ㇆, ㇝, ⺈, 口, 丨, 乚, 丶
肄	𠤕, 聿	匕, 矢, 聿	乚, ㇒, 丿, 一, 人, 一, 匚, 一, 丨, 二, 丨
疫	疒, 殳	疒, 殳	一, 丶, 厂, 丶, 丿, ㇠, ㇇, ㇏
亦	亠, No glyph available	亠, 丨, 亅, 八	一, 丶, 丨, 亅, 八
裔	衣, 冏	衣, 冂, 八, 口	一, 丶, ㇒, ㇗, 冫, 冂, 八, 口
意	音, 心	音, 心	一, 丶, 丷, 一, 口, 一, 𠁼, ㇃
毅	豙, 殳	立, 勹, No glyph availabl, No glyph availabl, 殳	一, 丶, 丷, 一, ㇆, ㇒, ㇒, 冫, 丿, ㇠, ㇇, ㇏
忆	忄, ㇠	忄, ㇠	丨, 八, ㇠
义	乂, 丶	乂, 丶	乂, 丶
益	No glyph available, 皿	丷, 一, 八, 皿	丷, 一, 八, 冂, 丨, 一
溢	氵, 益	氵, 丷, 一, 八, 皿	⺀, ㇀, 丷, 一, 八, 冂, 丨, 一
诣	讠, 旨	讠, 匕, 日	㇊, 丶, 乚, ㇒, 口, 一
议	讠, 义	讠, 乂, 丶	㇊, 丶, 乂, 丶
谊	讠, 宜	讠, 宀, 月, 一	㇊, 丶, 冖, 丶, 冂, 二, 一
译	讠, No glyph available	讠, 又, 二, 丨	㇊, 丶, ㇇, ㇏, 二, 丨
异	巳, 艹	巳, 艹	丨, 匚, 乚, 艹
翼	羽, 異	羽, 田, 艹, 一, 八	羽, 冂, 一, 丨, 一, 艹, 一, 八
翌	羽, 立	羽, 立	羽, 一, 丶, 丷, 一
绎	纟, No glyph available	纟, 又, 二, 丨	㇛, 一, ㇇, ㇏, 二, 丨
茵	艹, 因	艹, 囗, 大	艹, 冂, 一, 人, 一
荫	艹, 阴	艹, 阝, 月	艹, 丨, ㇌, 冂, 二
因	囗, 大	囗, 大	冂, 一, 人, 一
殷	㐆, 殳	丨, 彐, ㇆, 丶, 殳	丨, ㇕, 二, ㇆, 丶, 丿, ㇠, ㇇, ㇏
音	立, 日	音	一, 丶, 丷, 一, 口, 一
阴	阝, 月	阝, 月	丨, ㇌, 冂, 二
姻	女, 因	女, 囗, 大	㇛, 一, 丿, 冂, 一, 人, 一
吟	口, 今	口, 人, 丶, ㇇	口, 人, 丶, ㇇
银	钅, 艮	钅, 艮	丿, 一, 乚, 二, 丨, ㇕, 二, 乚, 冫
淫	氵, 㸒	氵, 爫, ㇒, 士	⺀, ㇀, 爫, ㇒, 一, 丨, 一
寅	宀, No glyph available	宀, 一, 二, 丨, 凵, 八	冖, 丶, 一, 二, 丨, 凵, 八
饮	饣, 欠	饣, 欠	⺈, 乚, ⺈, 人
尹	⺕, 丨	⺕, 丨	匚, 一, 丨
引	弓, 丨	弓, 丨	匚, ㇉, 丨
隐	阝, 急	阝, ⺈, 彐, 心	丨, ㇌, ⺈, ㇕, 二, 𠁼, ㇃
印	No glyph available, 卩	㇒, ㇗, 一, 卩	㇒, ㇗, 一, 丨, ㇆
英	艹, 央	艹, 大, 冂	艹, 人, 一, 冂
樱	木, 婴	木, No glyph availabl, 女	一, 丨, 八, 贝, ㇛, 一, 丿
婴	No glyph available, 女	No glyph availabl, 女	贝, ㇛, 一, 丿
鹰	䧹, 鸟	广, 亻, 隹, 鸟	厂, 丶, ㇒, 丨, ㇒, 丨, 一, 二, 丨, 一, 丶, ㇆, ㇉, 丶, 丶, 一
应	广, No glyph available	广, ⺍, 一	厂, 丶, ⺍, 一
缨	纟, 婴	纟, No glyph availabl, 女	㇛, 一, 贝, ㇛, 一, 丿
莹	艹, No glyph available	艹, 冖, 玉	艹, 冖, 一, 一, 丨, 一, 丶
萤	艹, No glyph available	艹, 冖, 虫	艹, 冖, 口, 丨, 𠂉
营	艹, No glyph available	艹, 冖, 吕	艹, 冖, 吕
荧	艹, No glyph available	艹, 冖, 火	艹, 冖, 丿, 丶, 冫
蝇	虫, 黾	虫, 黾	口, 丨, 𠂉, 口, 口, 一, 丨, 乚
迎	辶, 卬	辶, ㇒, ㇗, 卩	丶, ㇆, ㇝, ㇒, ㇗, 丨, ㇆
赢	𣎆, 贝	匸, 丶, 口, 月, 几, 丶, 贝	匸, 丶, 口, 冂, 二, 丿, ㇠, 丶, 冂, 人
盈	夃, 皿	㇎, 丿, 又, 皿	㇎, 丿, ㇇, ㇏, 冂, 丨, 一
影	景, 彡	日, 亠, 口, 小, 彡	口, 一, 一, 丶, 口, 亅, 八, 彡
颖	No glyph available, 页	匕, 禾, 页	乚, ㇒, ㇒, 一, 丨, 八, 一, 丿, 冂, 人
硬	石, 更	石, 一, 日, 丨, 乂	一, 丿, 口, 一, 口, 一, 丨, 乂
映	日, 央	日, 大, 冂	口, 一, 人, 一, 冂
哟	口, 约	口, 纟, 勹, 丶	口, ㇛, 一, ㇆, ㇒, 丶
拥	扌, 用	扌, 用	亅, 二, 冂, 二, 丨
佣	亻, 用	亻, 用	㇒, 丨, 冂, 二, 丨
臃	月, 雍	月, 亠, No glyph availabl, 丿, 隹	冂, 二, 一, 丶, ㇛, 丿, ㇒, 丨, 一, 二, 丨, 一, 丶
痈	疒, 用	疒, 用	一, 丶, 厂, 丶, 冂, 二, 丨
庸	广, No glyph available	广, ⺺, 用	厂, 丶, 匚, 一, 丨, 冂, 二, 丨
雍	亠, No glyph available	亠, No glyph availabl, 丿, 隹	一, 丶, ㇛, 丿, ㇒, 丨, 一, 二, 丨, 一, 丶
踊	⻊, 甬	⻊, 龴, 用	口, 丨, 一, 丨, 一, 龴, 冂, 二, 丨
蛹	虫, 甬	虫, 龴, 用	口, 丨, 𠂉, 龴, 冂, 二, 丨
咏	口, 永	口, ㇆, ㇇, No glyph availabl, 丶	口, ㇆, ㇇, 冫, 丶
泳	氵, 永	氵, ㇆, ㇇, No glyph availabl, 丶	⺀, ㇀, ㇆, ㇇, 冫, 丶
涌	氵, 甬	氵, 龴, 用	⺀, ㇀, 龴, 冂, 二, 丨
永	No glyph available, 丶	㇆, ㇇, No glyph availabl, 丶	㇆, ㇇, 冫, 丶
恿	龴, No glyph available	龴, 用, 心	龴, 冂, 二, 丨, 𠁼, ㇃
勇	龴, 男	龴, 田, 力	龴, 冂, 一, 丨, 一, ㇆, 丿
用	冂, No glyph available	用	冂, 二, 丨
幽	山, 𢆶	山, 𢆶	丨, 凵, 𢆶
优	亻, 尤	亻, 尢, 丶	㇒, 丨, 𠂇, 乚, 丶
悠	攸, 心	亻, 丨, ⺙, 心	㇒, 丨, 丨, 丿, 一, 乂, 𠁼, ㇃
忧	忄, 尤	忄, 尢, 丶	丨, 八, 𠂇, 乚, 丶
尤	尢, 丶	尢, 丶	𠂇, 乚, 丶
由	No glyph available, 凵	二, 丨, 凵	二, 丨, 凵
邮	由, 阝	二, 丨, 凵, 阝	二, 丨, 凵, 丨, ㇌
铀	钅, 由	钅, 二, 丨, 凵	丿, 一, 乚, 二, 二, 丨, 凵
犹	犭, 尤	犭, 尢, 丶	㇁, ㇒, 𠂇, 乚, 丶
油	氵, 由	氵, 二, 丨, 凵	⺀, ㇀, 二, 丨, 凵
游	氵, 斿	氵, 方, 丿, 一, 子	⺀, ㇀, 一, 丶, 丿, ㇆, 丿, 一, ㇇, 亅, 一
酉	兀, 日	酉	一, 丿, 乚, 口, 一
有	𠂇, 月	𠂇, 月	𠂇, 冂, 二
友	𠂇, 又	𠂇, 又	𠂇, ㇇, ㇏
右	𠂇, 口	𠂇, 口	𠂇, 口
佑	亻, 右	亻, 𠂇, 口	㇒, 丨, 𠂇, 口
釉	釆, 由	釆, 二, 丨, 凵	㇒, 一, 丨, 八, 丷, 二, 丨, 凵
诱	讠, 秀	讠, 禾, ㇎, 丿	㇊, 丶, ㇒, 一, 丨, 八, ㇎, 丿
又	㇇, ㇏	又	㇇, ㇏
幼	幺, 力	幺, 力	㇛, 丶, ㇆, 丿
迂	辶, 于	辶, 干, 亅	丶, ㇆, ㇝, 一, 一, 丨, 亅
淤	氵, 於	氵, 方, 人, ⺀	⺀, ㇀, 一, 丶, 丿, ㇆, 人, ⺀
于	干, 亅	干, 亅	一, 一, 丨, 亅
盂	于, 皿	干, 亅, 皿	一, 一, 丨, 亅, 冂, 丨, 一
榆	木, 俞	木, 人, 一, 月, 刂	一, 丨, 八, 人, 一, 冂, 二, 亅, 丨
虞	虍, 吴	虍, 口, 一, 大	丨, 一, 冖, 乚, 一, 口, 一, 人, 一
愚	禺, 心	冂, 二, 丨, 禸, 心	冂, 二, 丨, ㇛, 丶, 冂, 𠁼, ㇃
舆	No glyph available, No glyph available	臼, 车, 一, 八	臼, 乚, 一, 一, 丨, 一, 八
余	人, No glyph available	人, 干, 小	人, 一, 一, 丨, 亅, 八
俞	亼, 刖	人, 一, 月, 刂	人, 一, 冂, 二, 亅, 丨
逾	辶, 俞	辶, 人, 一, 月, 刂	丶, ㇆, ㇝, 人, 一, 冂, 二, 亅, 丨
鱼	No glyph available, 一	鱼	⺈, 冂, 一, 丨, 一, 一
愉	忄, 俞	忄, 人, 一, 月, 刂	丨, 八, 人, 一, 冂, 二, 亅, 丨
渝	氵, 俞	氵, 人, 一, 月, 刂	⺀, ㇀, 人, 一, 冂, 二, 亅, 丨
渔	氵, 鱼	氵, 鱼	⺀, ㇀, ⺈, 冂, 一, 丨, 一, 一
隅	阝, 禺	阝, 冂, 二, 丨, 禸	丨, ㇌, 冂, 二, 丨, ㇛, 丶, 冂
予	龴, 𠄐	龴, ㇖, 亅	龴, ㇖, 亅
娱	女, 吴	女, 口, 一, 大	㇛, 一, 丿, 口, 一, 人, 一
雨	帀, No glyph available	雨	一, 冂, 丨, 丶, ㇀, 冫
与	No glyph available, 一	No glyph availabl, 一	己, 一
屿	山, 与	山, No glyph availabl, 一	丨, 凵, 己, 一
禹	䖝, 冂	㇒, 虫, 冂	㇒, 口, 丨, 𠂉, 冂
宇	宀, 于	宀, 干, 亅	冖, 丶, 一, 一, 丨, 亅
语	讠, 吾	讠, 一, 力, 一, 口	㇊, 丶, 一, ㇆, 丿, 一, 口
羽	习	羽	羽
玉	王, 丶	玉	一, 一, 丨, 一, 丶
域	土, 或	土, 戈, 口, 一	一, 丨, 一, 戈, 口, 一
芋	艹, 于	艹, 干, 亅	艹, 一, 一, 丨, 亅
郁	有, 阝	𠂇, 月, 阝	𠂇, 冂, 二, 丨, ㇌
吁	口, 于	口, 干, 亅	口, 一, 一, 丨, 亅
遇	辶, 禺	辶, 冂, 二, 丨, 禸	丶, ㇆, ㇝, 冂, 二, 丨, ㇛, 丶, 冂
喻	口, 俞	口, 人, 一, 月, 刂	口, 人, 一, 冂, 二, 亅, 丨
峪	山, 谷	山, 谷	丨, 凵, 八, 人, 口
御	彳, 卸	彳, 干, ㇒, 止, 卩	㇒, 丨, 一, 一, 丨, ㇒, 丨, 一, 丨, 一, 丨, ㇆
愈	俞, 心	人, 一, 月, 刂, 心	人, 一, 冂, 二, 亅, 丨, 𠁼, ㇃
欲	谷, 欠	谷, 欠	八, 人, 口, ⺈, 人
狱	犭, No glyph available	犭, 讠, 犬	㇁, ㇒, ㇊, 丶, 人, 一, 丶
育	No glyph available, 月	亠, 厶, 月	一, 丶, ㇛, 丶, 冂, 二
誉	兴, 言	⺍, 一, 八, 言	⺍, 一, 八, 一, 丶, 二, 口
浴	氵, 谷	氵, 谷	⺀, ㇀, 八, 人, 口
寓	宀, 禺	宀, 冂, 二, 丨, 禸	冖, 丶, 冂, 二, 丨, ㇛, 丶, 冂
裕	衤, 谷	衤, 谷	一, 一, 丨, 一, 丶, 戈, 丨, 冫, 八, 人, 口
预	予, 页	龴, ㇖, 亅, 页	龴, ㇖, 亅, 一, 丿, 冂, 人
豫	予, 象	龴, ㇖, 亅, ⺈, 口, 丨, 勹, No glyph availabl, No glyph availabl	龴, ㇖, 亅, ⺈, 口, 丨, ㇆, ㇒, ㇒, 冫
驭	马, 又	马, 又	㇕, ㇉, 一, ㇇, ㇏
鸳	夗, 鸟	夕, 乚, ㇆, 鸟	夕, 乚, ㇆, ㇆, ㇉, 丶, 丶, 一
渊	氵, 𫃢	氵, 糹, 亻, 木	⺀, ㇀, ㇛, 丶, 丶, ㇒, 丨, 一, 丨, 八
冤	冖, 兔	冖, ⺈, 口, 丨, 乚, 丶	冖, ⺈, 口, 丨, 乚, 丶
元	二, 儿	二, 儿	二, 丿, 乚
垣	土, 亘	土, 一, 日, 一	一, 丨, 一, 一, 口, 一, 一
袁	土, No glyph available	土, 口, ㇒, ㇗, No glyph availabl	一, 丨, 一, 口, ㇒, ㇗, 冫
原	厂, 𤽄	厂, 白, 小	厂, 口, 一, ㇒, 亅, 八
援	扌, 爰	扌, 爫, 干, 又	亅, 二, 爫, 一, 一, 丨, ㇇, ㇏
辕	车, 袁	车, 土, 口, ㇒, ㇗, No glyph availabl	乚, 一, 一, 丨, 一, 丨, 一, 口, ㇒, ㇗, 冫
园	囗, 元	囗, 二, 儿	冂, 一, 二, 丿, 乚
员	口, 贝	口, 贝	口, 冂, 人
圆	囗, 员	囗, 口, 贝	冂, 一, 口, 冂, 人
猿	犭, 袁	犭, 土, 口, ㇒, ㇗, No glyph availabl	㇁, ㇒, 一, 丨, 一, 口, ㇒, ㇗, 冫
源	氵, 原	氵, 厂, 白, 小	⺀, ㇀, 厂, 口, 一, ㇒, 亅, 八
缘	纟, 彖	纟, 彑, 勹, No glyph availabl, No glyph availabl	㇛, 一, ㇗, ㇕, 一, ㇆, ㇒, ㇒, 冫
远	辶, 元	辶, 二, 儿	丶, ㇆, ㇝, 二, 丿, 乚
苑	艹, 夗	艹, 夕, 乚, ㇆	艹, 夕, 乚, ㇆
愿	原, 心	厂, 白, 小, 心	厂, 口, 一, ㇒, 亅, 八, 𠁼, ㇃
怨	夗, 心	夕, 乚, ㇆, 心	夕, 乚, ㇆, 𠁼, ㇃
院	阝, 完	阝, 宀, 二, 儿	丨, ㇌, 冖, 丶, 二, 丿, 乚
曰	口, 一	曰	口, 一
约	纟, 勺	纟, 勹, 丶	㇛, 一, ㇆, ㇒, 丶
越	走, 戉	走, 匚, 戈	一, 丨, 一, 龰, 一, ㇗, 戈
跃	⻊, 夭	⻊, ㇒, 大	口, 丨, 一, 丨, 一, ㇒, 人, 一
钥	钅, 月	钅, 月	丿, 一, 乚, 二, 冂, 二
岳	丘, 山	斤, 一, 山	丿, ㇒, 一, 丨, 一, 丨, 凵
粤	No glyph available, 丂	囗, 丶, 米, 一, ㇉	冂, 一, 丶, 一, 丨, 八, 丷, 一, ㇉
月	冂, 二	月	冂, 二
悦	忄, 兑	忄, 丷, 口, 儿	丨, 八, 丷, 口, 丿, 乚
阅	门, 兑	门, 丷, 口, 儿	丶, 丨, ㇆, 丷, 口, 丿, 乚
耘	耒, 云	耒, 二, 厶	一, 二, 丨, 八, 二, ㇛, 丶
云	二, 厶	二, 厶	二, ㇛, 丶
郧	员, 阝	口, 贝, 阝	口, 冂, 人, 丨, ㇌
匀	勹, 亠	勹, 亠	㇆, ㇒, 一, 丶
陨	阝, 员	阝, 口, 贝	丨, ㇌, 口, 冂, 人
允	厶, 儿	厶, 儿	㇛, 丶, 丿, 乚
运	辶, 云	辶, 二, 厶	丶, ㇆, ㇝, 二, ㇛, 丶
蕴	艹, 缊	艹, 纟, 日, 皿	艹, ㇛, 一, 口, 一, 冂, 丨, 一
酝	酉, 云	酉, 二, 厶	一, 丿, 乚, 口, 一, 二, ㇛, 丶
晕	日, 军	日, 冖, 车	口, 一, 冖, 乚, 一, 一, 丨
韵	音, 匀	音, 勹, 亠	一, 丶, 丷, 一, 口, 一, ㇆, ㇒, 一, 丶
孕	乃, 子	㇎, 丿, 子	㇎, 丿, ㇇, 亅, 一
匝	匚, 巾	匚, 巾	一, ㇗, 冂, 丨
砸	石, 匝	石, 匚, 巾	一, 丿, 口, 一, ㇗, 冂, 丨
杂	九, 朩	丿, ㇈, 十, 小	丿, ㇈, 一, 丨, 亅, 八
栽	𢦏, 木	土, 戈, 木	一, 丨, 一, 戈, 一, 丨, 八
哉	𢦏, 口	土, 戈, 口	一, 丨, 一, 戈, 口
灾	宀, 火	宀, 火	冖, 丶, 丿, 丶, 冫
宰	宀, 辛	宀, 辛	冖, 丶, 一, 丶, 丷, 一, 一, 丨
载	𢦏, 车	土, 戈, 车	一, 丨, 一, 戈, 乚, 一, 一, 丨
再	一, 冉	一, 冂, 土	一, 冂, 一, 丨, 一
在	𠂇, No glyph available	𠂇, 亻, 土	𠂇, ㇒, 丨, 一, 丨, 一
咱	口, 自	口, 自	口, 口, 二, 丶
攒	扌, 赞	扌, 兟, 贝	亅, 二, 兟, 冂, 人
暂	斩, 日	车, 斤, 日	乚, 一, 一, 丨, 丿, ㇒, 一, 丨, 口, 一
赞	兟, 贝	兟, 贝	兟, 冂, 人
赃	贝, 庄	贝, 广, 土	冂, 人, 厂, 丶, 一, 丨, 一
脏	月, 庄	月, 广, 土	冂, 二, 厂, 丶, 一, 丨, 一
葬	艹, No glyph available	艹, 歹, 匕, 艹	艹, 一, 夕, 乚, ㇒, 艹
遭	辶, 曹	辶, 艹, No glyph availabl, 二, 凵, 日	丶, ㇆, ㇝, 艹, 丨, 二, 凵, 口, 一
糟	米, 曹	米, 艹, No glyph availabl, 二, 凵, 日	一, 丨, 八, 丷, 艹, 丨, 二, 凵, 口, 一
凿	业, No glyph available	No glyph availabl, 丷, 一, 丷, 干, 凵	丨, 丷, 一, 丷, 一, 一, 丨, 凵
藻	艹, 澡	艹, 氵, 品, 木	艹, ⺀, ㇀, 品, 一, 丨, 八
枣	朿, ⺀	木, 冂, ⺀	一, 丨, 八, 冂, ⺀
早	日, 十	日, 十	口, 一, 一, 丨
澡	氵, 喿	氵, 品, 木	⺀, ㇀, 品, 一, 丨, 八
蚤	叉, 虫	又, 丶, 虫	㇇, ㇏, 丶, 口, 丨, 𠂉
躁	⻊, 喿	⻊, 品, 木	口, 丨, 一, 丨, 一, 品, 一, 丨, 八
噪	口, 喿	口, 品, 木	口, 品, 一, 丨, 八
造	辶, 告	辶, ⺧, 口	丶, ㇆, ㇝, ⺧, 口
皂	白, 七	白, 乚, 一	口, 一, ㇒, 乚, 一
灶	火, 土	火, 土	丿, 丶, 冫, 一, 丨, 一
燥	火, 喿	火, 品, 木	丿, 丶, 冫, 品, 一, 丨, 八
责	龶, 贝	龶, 贝	龶, 冂, 人
择	扌, No glyph available	扌, 又, 二, 丨	亅, 二, ㇇, ㇏, 二, 丨
则	贝, 刂	贝, 刂	冂, 人, 亅, 丨
泽	氵, No glyph available	氵, 又, 二, 丨	⺀, ㇀, ㇇, ㇏, 二, 丨
贼	贝, 戎	贝, 戈, 𠂇	冂, 人, 戈, 𠂇
怎	乍, 心	丿, 一, 丨, 二, 心	丿, 一, 丨, 二, 𠁼, ㇃
增	土, 曾	土, 丷, 口, 丨, 丷, 日	一, 丨, 一, 丷, 口, 丨, 丷, 口, 一
憎	忄, 曾	忄, 丷, 口, 丨, 丷, 日	丨, 八, 丷, 口, 丨, 丷, 口, 一
曾	No glyph available, 日	丷, 口, 丨, 丷, 日	丷, 口, 丨, 丷, 口, 一
赠	贝, 曾	贝, 丷, 口, 丨, 丷, 日	冂, 人, 丷, 口, 丨, 丷, 口, 一
扎	扌, 乚	扌, 乚	亅, 二, 乚
喳	口, 查	口, 木, 日, 一	口, 一, 丨, 八, 口, 一, 一
渣	氵, 查	氵, 木, 日, 一	⺀, ㇀, 一, 丨, 八, 口, 一, 一
札	木, 乚	木, 乚	一, 丨, 八, 乚
轧	车, 乚	车, 乚	乚, 一, 一, 丨, 乚
铡	钅, 则	钅, 贝, 刂	丿, 一, 乚, 二, 冂, 人, 亅, 丨
闸	门, 甲	门, 冂, 二, 丨	丶, 丨, ㇆, 冂, 二, 丨
眨	目, 乏	目, ㇒, 王, 丶, 戈, ㇝	口, 二, ㇒, 一, 一, 丨, 一, 丶, 戈, ㇝
栅	木, 册	木, 册	一, 丨, 八, 册
榨	木, 窄	木, 穴, 丿, 一, 丨, 二	一, 丨, 八, 冖, 丶, 八, 丿, 一, 丨, 二
咋	口, 乍	口, 丿, 一, 丨, 二	口, 丿, 一, 丨, 二
乍	No glyph available, 二	丿, 一, 丨, 二	丿, 一, 丨, 二
炸	火, 乍	火, 丿, 一, 丨, 二	丿, 丶, 冫, 丿, 一, 丨, 二
诈	讠, 乍	讠, 丿, 一, 丨, 二	㇊, 丶, 丿, 一, 丨, 二
摘	扌, 啇	扌, 亠, 丷, 欠, 子	亅, 二, 一, 丶, 丷, ⺈, 人, ㇇, 亅, 一
斋	文, 而	文, 而	一, 丶, 乂, 一, 丿, 冂, 丨
宅	宀, 乇	宀, ㇒, 乚, 一	冖, 丶, ㇒, 乚, 一
窄	穴, 乍	穴, 丿, 一, 丨, 二	冖, 丶, 八, 丿, 一, 丨, 二
债	亻, 责	亻, 龶, 贝	㇒, 丨, 龶, 冂, 人
寨	No glyph available, 朩	宀, No glyph availabl, 二, 一, 八, 十, 小	冖, 丶, 丨, 二, 一, 八, 一, 丨, 亅, 八
瞻	目, 詹	目, ⺈, 厂, 八, 言	口, 二, ⺈, 厂, 八, 一, 丶, 二, 口
毡	毛, 占	毛, ⺊, 口	㇒, 二, 乚, 丨, 一, 口
詹	⺈, No glyph available	⺈, 厂, 八, 言	⺈, 厂, 八, 一, 丶, 二, 口
粘	米, 占	米, ⺊, 口	一, 丨, 八, 丷, 丨, 一, 口
沾	氵, 占	氵, ⺊, 口	⺀, ㇀, 丨, 一, 口
盏	戋, 皿	戋, 皿	戋, 冂, 丨, 一
斩	车, 斤	车, 斤	乚, 一, 一, 丨, 丿, ㇒, 一, 丨
辗	车, 展	车, 尸, 艹, 一, 乚, No glyph availabl	乚, 一, 一, 丨, 丨, 匚, 艹, 一, 乚, 冫
崭	山, 斩	山, 车, 斤	丨, 凵, 乚, 一, 一, 丨, 丿, ㇒, 一, 丨
展	尸, No glyph available	尸, 艹, 一, 乚, No glyph availabl	丨, 匚, 艹, 一, 乚, 冫
蘸	艹, 醮	艹, 酉, 隹, 灬	艹, 一, 丿, 乚, 口, 一, ㇒, 丨, 一, 二, 丨, 一, 丶, 灬
栈	木, 戋	木, 戋	一, 丨, 八, 戋
占	⺊, 口	⺊, 口	丨, 一, 口
战	占, 戈	⺊, 口, 戈	丨, 一, 口, 戈
站	立, 占	立, ⺊, 口	一, 丶, 丷, 一, 丨, 一, 口
湛	氵, 甚	氵, 甘, 匚, 儿	⺀, ㇀, 艹, 二, 一, ㇗, 丿, 乚
绽	纟, 定	纟, 宀, 一, 龰	㇛, 一, 冖, 丶, 一, 龰
樟	木, 章	木, 立, 日, 十	一, 丨, 八, 一, 丶, 丷, 一, 口, 一, 一, 丨
章	立, 早	立, 日, 十	一, 丶, 丷, 一, 口, 一, 一, 丨
彰	章, 彡	立, 日, 十, 彡	一, 丶, 丷, 一, 口, 一, 一, 丨, 彡
漳	氵, 章	氵, 立, 日, 十	⺀, ㇀, 一, 丶, 丷, 一, 口, 一, 一, 丨
张	弓, 长	弓, 长	匚, ㇉, 乚, 冫, 一
掌	No glyph available, 手	⺌, 冖, 口, 手	丨, 丷, 冖, 口, ㇒, 亅, 二
涨	氵, 张	氵, 弓, 长	⺀, ㇀, 匚, ㇉, 乚, 冫, 一
杖	木, 丈	木, 十, 乂	一, 丨, 八, 一, 丨, 乂
丈	十, 乂	十, 乂	一, 丨, 乂
帐	巾, 长	巾, 长	冂, 丨, 乚, 冫, 一
账	贝, 长	贝, 长	冂, 人, 乚, 冫, 一
仗	亻, 丈	亻, 十, 乂	㇒, 丨, 一, 丨, 乂
胀	月, 长	月, 长	冂, 二, 乚, 冫, 一
瘴	疒, 章	疒, 立, 日, 十	一, 丶, 厂, 丶, 一, 丶, 丷, 一, 口, 一, 一, 丨
障	阝, 章	阝, 立, 日, 十	丨, ㇌, 一, 丶, 丷, 一, 口, 一, 一, 丨
招	扌, 召	扌, 刀, 口	亅, 二, ㇆, 丿, 口
昭	日, 召	日, 刀, 口	口, 一, ㇆, 丿, 口
找	扌, 戈	扌, 戈	亅, 二, 戈
沼	氵, 召	氵, 刀, 口	⺀, ㇀, ㇆, 丿, 口
赵	走, 乂	走, 乂	一, 丨, 一, 龰, 乂
照	昭, 灬	日, 刀, 口, 灬	口, 一, ㇆, 丿, 口, 灬
罩	罒, 卓	罒, ⺊, 日, 十	口, 丨, 丨, 一, 口, 一, 一, 丨
兆	儿, No glyph available	儿, 冫, No glyph availabl	丿, 乚, 丶, ㇀, 冫
肇	𢼄, 聿	户, ⺙, 聿	丨, 匚, 丶, 丿, 一, 乂, 匚, 一, 丨, 二, 丨
召	刀, 口	刀, 口	㇆, 丿, 口
遮	辶, 庶	辶, 广, 廿, 灬	丶, ㇆, ㇝, 厂, 丶, 卄, 一, 灬
折	扌, 斤	扌, 斤	亅, 二, 丿, ㇒, 一, 丨
哲	折, 口	扌, 斤, 口	亅, 二, 丿, ㇒, 一, 丨, 口
蛰	执, 虫	扌, 丿, ㇈, 丶, 虫	亅, 二, 丿, ㇈, 丶, 口, 丨, 𠂉
辙	车, No glyph available	车, 亠, 厶, 月, ⺙	乚, 一, 一, 丨, 一, 丶, ㇛, 丶, 冂, 二, 丿, 一, 乂
者	耂, 日	耂, 日	耂, 口, 一
锗	钅, 者	钅, 耂, 日	丿, 一, 乚, 二, 耂, 口, 一
蔗	艹, 庶	艹, 广, 廿, 灬	艹, 厂, 丶, 卄, 一, 灬
这	辶, 文	辶, 文	丶, ㇆, ㇝, 一, 丶, 乂
浙	氵, 折	氵, 扌, 斤	⺀, ㇀, 亅, 二, 丿, ㇒, 一, 丨
珍	王, 㐱	王, 人, 彡	一, 一, 丨, 一, 人, 彡
斟	甚, 斗	甘, 匚, 儿, 斗	艹, 二, 一, ㇗, 丿, 乚, 一, 丨, ⺀
真	十, 具	十, 目, 一, 八	一, 丨, 口, 二, 一, 八
甄	垔, 瓦	西, 土, 瓦	一, 丿, 乚, 冂, 一, 一, 丨, 一, 匸, ㇈, 丶
砧	石, 占	石, ⺊, 口	一, 丿, 口, 丨, 一, 口
臻	至, 秦	至, 一, 二, 丨, 八, 禾	一, ㇛, 丶, 一, 丨, 一, 一, 二, 丨, 八, ㇒, 一, 丨, 八
贞	⺊, 贝	⺊, 贝	丨, 一, 冂, 人
针	钅, 十	钅, 十	丿, 一, 乚, 二, 一, 丨
侦	亻, 贞	亻, ⺊, 贝	㇒, 丨, 丨, 一, 冂, 人
枕	木, 冘	木, 巾, 乚	一, 丨, 八, 冂, 丨, 乚
疹	疒, 㐱	疒, 人, 彡	一, 丶, 厂, 丶, 人, 彡
诊	讠, 㐱	讠, 人, 彡	㇊, 丶, 人, 彡
震	雨, 辰	雨, 辰	一, 冂, 丨, 丶, ㇀, 冫, 厂, 二, 乚, 冫
振	扌, 辰	扌, 辰	亅, 二, 厂, 二, 乚, 冫
镇	钅, 真	钅, 十, 目, 一, 八	丿, 一, 乚, 二, 一, 丨, 口, 二, 一, 八
阵	阝, 车	阝, 车	丨, ㇌, 乚, 一, 一, 丨
蒸	艹, 烝	艹, ㇖, 水, 一, 灬	艹, ㇖, 亅, ㇇, 冫, 一, 灬
挣	扌, 争	扌, ⺈, ⺕, 亅	亅, 二, ⺈, 匚, 一, 亅
睁	目, 争	目, ⺈, ⺕, 亅	口, 二, ⺈, 匚, 一, 亅
征	彳, 正	彳, 一, 止	㇒, 丨, 一, 丨, 一, 丨, 一
狰	犭, 争	犭, ⺈, ⺕, 亅	㇁, ㇒, ⺈, 匚, 一, 亅
争	⺈, No glyph available	⺈, ⺕, 亅	⺈, 匚, 一, 亅
怔	忄, 正	忄, 一, 止	丨, 八, 一, 丨, 一, 丨, 一
整	敕, 正	木, 口, ⺙, 一, 止	一, 丨, 八, 口, 丿, 一, 乂, 一, 丨, 一, 丨, 一
拯	扌, 丞	扌, ㇖, 水, 一	亅, 二, ㇖, 亅, ㇇, 冫, 一
正	一, 止	一, 止	一, 丨, 一, 丨, 一
政	正, ⺙	一, 止, ⺙	一, 丨, 一, 丨, 一, 丿, 一, 乂
帧	巾, 贞	巾, ⺊, 贝	冂, 丨, 丨, 一, 冂, 人
症	疒, 正	疒, 一, 止	一, 丶, 厂, 丶, 一, 丨, 一, 丨, 一
郑	关, 阝	丷, 一, 大, 阝	丷, 一, 人, 一, 丨, ㇌
证	讠, 正	讠, 一, 止	㇊, 丶, 一, 丨, 一, 丨, 一
芝	艹, 之	艹, 王, 丶, 戈, ㇝	艹, 一, 一, 丨, 一, 丶, 戈, ㇝
枝	木, 支	木, 支	一, 丨, 八, 一, 丨, ㇇, ㇏
支	十, 又	支	一, 丨, ㇇, ㇏
吱	口, 支	口, 支	口, 一, 丨, ㇇, ㇏
蜘	虫, 知	虫, 矢, 口	口, 丨, 𠂉, 丿, 一, 人, 一, 口
知	矢, 口	矢, 口	丿, 一, 人, 一, 口
肢	月, 支	月, 支	冂, 二, 一, 丨, ㇇, ㇏
脂	月, 旨	月, 匕, 日	冂, 二, 乚, ㇒, 口, 一
汁	氵, 十	氵, 十	⺀, ㇀, 一, 丨
之	𪜋, ㇝	王, 丶, 戈, ㇝	一, 一, 丨, 一, 丶, 戈, ㇝
织	纟, 只	纟, 口, 八	㇛, 一, 口, 八
职	耳, 只	耳, 口, 八	二, 丨, 二, 口, 八
直	十, No glyph available	十, 目, 一	一, 丨, 口, 二, 一
植	木, 直	木, 十, 目, 一	一, 丨, 八, 一, 丨, 口, 二, 一
殖	歹, 直	歹, 十, 目, 一	一, 夕, 一, 丨, 口, 二, 一
执	扌, 丸	扌, 丿, ㇈, 丶	亅, 二, 丿, ㇈, 丶
值	亻, 直	亻, 十, 目, 一	㇒, 丨, 一, 丨, 口, 二, 一
侄	亻, 至	亻, 至	㇒, 丨, 一, ㇛, 丶, 一, 丨, 一
址	土, 止	土, 止	一, 丨, 一, 丨, 一, 丨, 一
指	扌, 旨	扌, 匕, 日	亅, 二, 乚, ㇒, 口, 一
止	⺊, 丄	止	丨, 一, 丨, 一
趾	⻊, 止	⻊, 止	口, 丨, 一, 丨, 一, 丨, 一, 丨, 一
只	口, 八	口, 八	口, 八
旨	匕, 日	匕, 日	乚, ㇒, 口, 一
纸	纟, 氏	纟, 氏	㇛, 一, ㇒, ㇗, ㇂, 一
志	士, 心	士, 心	一, 丨, 一, 𠁼, ㇃
挚	执, 手	扌, 丿, ㇈, 丶, 手	亅, 二, 丿, ㇈, 丶, ㇒, 亅, 二
掷	扌, 郑	扌, 丷, 一, 大, 阝	亅, 二, 丷, 一, 人, 一, 丨, ㇌
至	𠫔, 土	至	一, ㇛, 丶, 一, 丨, 一
致	至, ⺙	至, ⺙	一, ㇛, 丶, 一, 丨, 一, 丿, 一, 乂
置	罒, 直	罒, 十, 目, 一	口, 丨, 一, 丨, 口, 二, 一
帜	巾, 只	巾, 口, 八	冂, 丨, 口, 八
峙	山, 寺	山, 土, 寸	丨, 凵, 一, 丨, 一, 𠂇, 亅, 丶
制	No glyph available, 刂	牛, 巾, 刂	二, 丨, ㇒, 冂, 丨, 亅, 丨
智	知, 日	矢, 口, 日	丿, 一, 人, 一, 口, 口, 一
秩	禾, 失	禾, 人, 二, ㇒	㇒, 一, 丨, 八, 人, 二, ㇒
稚	禾, 隹	禾, 隹	㇒, 一, 丨, 八, ㇒, 丨, 一, 二, 丨, 一, 丶
质	𣂑, 贝	⺁, 十, 贝	丿, ㇒, 一, 丨, 冂, 人
炙	月, 火	月, 火	冂, 二, 丿, 丶, 冫
痔	疒, 寺	疒, 土, 寸	一, 丶, 厂, 丶, 一, 丨, 一, 𠂇, 亅, 丶
滞	氵, 带	氵, 川, 一, 冖, 巾	⺀, ㇀, 川, 一, 冖, 冂, 丨
治	氵, 台	氵, 厶, 口	⺀, ㇀, ㇛, 丶, 口
窒	穴, 至	穴, 至	冖, 丶, 八, 一, ㇛, 丶, 一, 丨, 一
中	口, 丨	口, 丨	口, 丨
盅	中, 皿	口, 丨, 皿	口, 丨, 冂, 丨, 一
忠	中, 心	口, 丨, 心	口, 丨, 𠁼, ㇃
钟	钅, 中	钅, 口, 丨	丿, 一, 乚, 二, 口, 丨
衷	衣, 中	衣, 口, 丨	一, 丶, ㇒, ㇗, 冫, 口, 丨
终	纟, 冬	纟, 夂, ⺀	㇛, 一, ㇇, ㇏, ㇒, ⺀
种	禾, 中	禾, 口, 丨	㇒, 一, 丨, 八, 口, 丨
肿	月, 中	月, 口, 丨	冂, 二, 口, 丨
重	千, 里	㇒, 十, 里	㇒, 一, 丨, 冂, 一, 丨, 一, 一, 丨, 一
仲	亻, 中	亻, 口, 丨	㇒, 丨, 口, 丨
众	人	众	众
舟	No glyph available, No glyph available	舟	冂, 丶, ⺀, 一
周	田, 口	田, 口	冂, 一, 丨, 一, 口
州	No glyph available	州	州
洲	氵, 州	氵, 州	⺀, ㇀, 州
诌	讠, 刍	讠, ⺈, 彐	㇊, 丶, ⺈, ㇕, 二
粥	弜, 米	弜, 米	弜, 一, 丨, 八, 丷
轴	车, 由	车, 二, 丨, 凵	乚, 一, 一, 丨, 二, 丨, 凵
肘	月, 寸	月, 寸	冂, 二, 𠂇, 亅, 丶
帚	彐, No glyph available	彐, 冖, 巾	㇕, 二, 冖, 冂, 丨
咒	吅, 几	吅, 几	吅, 丿, ㇠
皱	刍, 皮	⺈, 彐, 皮	⺈, ㇕, 二, 丿, ㇆, 丨, ㇇, ㇏
宙	宀, 由	宀, 二, 丨, 凵	冖, 丶, 二, 丨, 凵
昼	尺, 旦	尸, ㇏, 日, 一	丨, 匚, ㇏, 口, 一, 一
骤	马, 聚	马, 耳, 又, 乑	㇕, ㇉, 一, 二, 丨, 二, ㇇, ㇏, 乑
珠	王, 朱	王, 木, 一, ㇒	一, 一, 丨, 一, 一, 丨, 八, 一, ㇒
株	木, 朱	木, 木, 一, ㇒	一, 丨, 八, 一, 丨, 八, 一, ㇒
蛛	虫, 朱	虫, 木, 一, ㇒	口, 丨, 𠂉, 一, 丨, 八, 一, ㇒
朱	未, ㇒	木, 一, ㇒	一, 丨, 八, 一, ㇒
猪	犭, 者	犭, 耂, 日	㇁, ㇒, 耂, 口, 一
诸	讠, 者	讠, 耂, 日	㇊, 丶, 耂, 口, 一
诛	讠, 朱	讠, 木, 一, ㇒	㇊, 丶, 一, 丨, 八, 一, ㇒
逐	辶, 豕	辶, 豕	丶, ㇆, ㇝, 一, ㇆, ㇒, ㇒, 冫
竹	No glyph available, 亅	竹	𠂉, 丨, 亅
烛	火, 虫	火, 虫	丿, 丶, 冫, 口, 丨, 𠂉
煮	者, 灬	耂, 日, 灬	耂, 口, 一, 灬
拄	扌, 主	扌, 王, 丶	亅, 二, 一, 一, 丨, 一, 丶
瞩	目, 属	目, 尸, ㇒, 虫, 冂	口, 二, 丨, 匚, ㇒, 口, 丨, 𠂉, 冂
嘱	口, 属	口, 尸, ㇒, 虫, 冂	口, 丨, 匚, ㇒, 口, 丨, 𠂉, 冂
主	王, 丶	王, 丶	一, 一, 丨, 一, 丶
著	艹, 者	艹, 耂, 日	艹, 耂, 口, 一
柱	木, 主	木, 王, 丶	一, 丨, 八, 一, 一, 丨, 一, 丶
助	且, 力	月, 一, 力	冂, 二, 一, ㇆, 丿
蛀	虫, 主	虫, 王, 丶	口, 丨, 𠂉, 一, 一, 丨, 一, 丶
贮	贝, 㝉	贝, 宀, 一	冂, 人, 冖, 丶, 一
铸	钅, 寿	钅, 一, 二, 丨, 寸	丿, 一, 乚, 二, 一, 二, 丨, 𠂇, 亅, 丶
筑	⺮, 巩	⺮, 工, 几, 丶	⺮, 一, 丨, 一, 丿, ㇠, 丶
住	亻, 主	亻, 王, 丶	㇒, 丨, 一, 一, 丨, 一, 丶
注	氵, 主	氵, 王, 丶	⺀, ㇀, 一, 一, 丨, 一, 丶
祝	礻, 兄	礻, 口, 儿	一, 一, 丨, 一, 丶, 戈, 丨, 丶, 口, 丿, 乚
驻	马, 主	马, 王, 丶	㇕, ㇉, 一, 一, 一, 丨, 一, 丶
抓	扌, 爪	扌, 爪	亅, 二, 丿, ㇒, ㇏, 丨
爪	No glyph available, 丨	爪	丿, ㇒, ㇏, 丨
拽	扌, 曳	扌, 曳	亅, 二, 曳
专	No glyph available, 龴	二, 丨, 龴	二, 丨, 龴
砖	石, 专	石, 二, 丨, 龴	一, 丿, 口, 二, 丨, 龴
转	车, 专	车, 二, 丨, 龴	乚, 一, 一, 丨, 二, 丨, 龴
撰	扌, 巽	扌, No glyph availabl, 艹, 一, 八	亅, 二, 巳, 艹, 一, 八
赚	贝, 兼	贝, 丷, 一, No glyph availabl, 八, ⺕	冂, 人, 丷, 一, 丨, 八, 匚, 一
篆	⺮, 彖	⺮, 彑, 勹, No glyph availabl, No glyph availabl	⺮, ㇗, ㇕, 一, ㇆, ㇒, ㇒, 冫
桩	木, 庄	木, 广, 土	一, 丨, 八, 厂, 丶, 一, 丨, 一
庄	广, 土	广, 土	厂, 丶, 一, 丨, 一
装	壮, 衣	丬, 士, 衣	一, 丶, 丨, 一, 丨, 一, 一, 丶, ㇒, ㇗, 冫
妆	丬, 女	丬, 女	一, 丶, 丨, ㇛, 一, 丿
撞	扌, 童	扌, 立, 里	亅, 二, 一, 丶, 丷, 一, 冂, 一, 丨, 一, 一, 丨, 一
壮	丬, 士	丬, 士	一, 丶, 丨, 一, 丨, 一
状	丬, 犬	丬, 犬	一, 丶, 丨, 人, 一, 丶
椎	木, 隹	木, 隹	一, 丨, 八, ㇒, 丨, 一, 二, 丨, 一, 丶
锥	钅, 隹	钅, 隹	丿, 一, 乚, 二, ㇒, 丨, 一, 二, 丨, 一, 丶
追	辶, 𠂤	辶, 㠯, 丶	丶, ㇆, ㇝, 㠯, 丶
赘	敖, 贝	龶, 一, 丿, ㇆, ⺙, 贝	龶, 一, 丿, ㇆, 丿, 一, 乂, 冂, 人
坠	队, 土	阝, 人, 土	丨, ㇌, 人, 一, 丨, 一
缀	纟, 叕	纟, 叕	㇛, 一, 叕
谆	讠, 享	讠, 亠, 口, 子	㇊, 丶, 一, 丶, 口, ㇇, 亅, 一
准	冫, 隹	冫, 隹	丶, ㇀, ㇒, 丨, 一, 二, 丨, 一, 丶
捉	扌, 足	扌, 足	亅, 二, 口, 龰
拙	扌, 出	扌, 出	亅, 二, 出
卓	⺊, 早	⺊, 日, 十	丨, 一, 口, 一, 一, 丨
桌	No glyph available, 木	⺊, 日, 木	丨, 一, 口, 一, 一, 丨, 八
琢	王, 豖	王, 一, 勹, No glyph availabl, 丶, No glyph availabl	一, 一, 丨, 一, 一, ㇆, ㇒, ㇒, 丶, 冫
茁	艹, 出	艹, 出	艹, 出
酌	酉, 勺	酉, 勹, 丶	一, 丿, 乚, 口, 一, ㇆, ㇒, 丶
啄	口, 豖	口, 一, 勹, No glyph availabl, 丶, No glyph availabl	口, 一, ㇆, ㇒, ㇒, 丶, 冫
着	羊, 目	羊, 目	一, 二, 丨, 丷, 口, 二
灼	火, 勺	火, 勹, 丶	丿, 丶, 冫, ㇆, ㇒, 丶
浊	氵, 虫	氵, 虫	⺀, ㇀, 口, 丨, 𠂉
兹	䒑, 𢆶	丷, 一, 𢆶	丷, 一, 𢆶
咨	次, 口	冫, 欠, 口	丶, ㇀, ⺈, 人, 口
资	次, 贝	冫, 欠, 贝	丶, ㇀, ⺈, 人, 冂, 人
姿	次, 女	冫, 欠, 女	丶, ㇀, ⺈, 人, ㇛, 一, 丿
滋	氵, 兹	氵, 丷, 一, 𢆶	⺀, ㇀, 丷, 一, 𢆶
淄	氵, 甾	氵, 巛, 田	⺀, ㇀, 巛, 冂, 一, 丨, 一
孜	子, ⺙	子, ⺙	㇇, 亅, 一, 丿, 一, 乂
紫	此, 糸	止, 匕, 糸	丨, 一, 丨, 一, 乚, ㇒, ㇛, 丶, 亅, 八
仔	亻, 子	亻, 子	㇒, 丨, ㇇, 亅, 一
籽	米, 子	米, 子	一, 丨, 八, 丷, ㇇, 亅, 一
滓	氵, 宰	氵, 宀, 辛	⺀, ㇀, 冖, 丶, 一, 丶, 丷, 一, 一, 丨
子	了, 一	子	㇇, 亅, 一
自	目, 丶	自	口, 二, 丶
渍	氵, 责	氵, 龶, 贝	⺀, ㇀, 龶, 冂, 人
字	宀, 子	宀, 子	冖, 丶, ㇇, 亅, 一
鬃	髟, 宗	髟, 宀, 示	彐, 一, ㇛, 丶, 彡, 冖, 丶, 二, 亅, 八
棕	木, 宗	木, 宀, 示	一, 丨, 八, 冖, 丶, 二, 亅, 八
踪	⻊, 宗	⻊, 宀, 示	口, 丨, 一, 丨, 一, 冖, 丶, 二, 亅, 八
宗	宀, 示	宀, 示	冖, 丶, 二, 亅, 八
综	纟, 宗	纟, 宀, 示	㇛, 一, 冖, 丶, 二, 亅, 八
总	𠮦, 心	丷, 口, 心	丷, 口, 𠁼, ㇃
纵	纟, 从	纟, 从	㇛, 一, 从
邹	刍, 阝	⺈, 彐, 阝	⺈, ㇕, 二, 丨, ㇌
走	土, 龰	走	一, 丨, 一, 龰
奏	𡗗, 天	一, 二, 丨, 八, 一, 大	一, 二, 丨, 八, 一, 人, 一
揍	扌, No glyph available	扌, 一, 二, 丨, 八, ㇒, 大	亅, 二, 一, 二, 丨, 八, ㇒, 人, 一
租	禾, 且	禾, 月, 一	㇒, 一, 丨, 八, 冂, 二, 一
足	口, 龰	足	口, 龰
卒	亠, No glyph available	亠, 从, 十	一, 丶, 从, 一, 丨
族	方, No glyph available	方, 丿, 一, 矢	一, 丶, 丿, ㇆, 丿, 一, 丿, 一, 人, 一
祖	礻, 且	礻, 月, 一	一, 一, 丨, 一, 丶, 戈, 丨, 丶, 冂, 二, 一
诅	讠, 且	讠, 月, 一	㇊, 丶, 冂, 二, 一
阻	阝, 且	阝, 月, 一	丨, ㇌, 冂, 二, 一
组	纟, 且	纟, 月, 一	㇛, 一, 冂, 二, 一
钻	钅, 占	钅, ⺊, 口	丿, 一, 乚, 二, 丨, 一, 口
纂	⺮, No glyph available	⺮, 目, 大, 糸	⺮, 口, 二, 人, 一, ㇛, 丶, 亅, 八
嘴	口, 觜	口, 止, 匕, 角	口, 丨, 一, 丨, 一, 乚, ㇒, ⺈, 冂, 二, 丨
醉	酉, 卒	酉, 亠, 从, 十	一, 丿, 乚, 口, 一, 一, 丶, 从, 一, 丨
最	曰, 取	曰, 耳, 又	口, 一, 二, 丨, 二, ㇇, ㇏
罪	罒, 非	罒, 非	口, 丨, 非
尊	酋, 寸	丷, 酉, 寸	丷, 一, 丿, 乚, 口, 一, 𠂇, 亅, 丶
遵	辶, 尊	辶, 丷, 酉, 寸	丶, ㇆, ㇝, 丷, 一, 丿, 乚, 口, 一, 𠂇, 亅, 丶
昨	日, 乍	日, 丿, 一, 丨, 二	口, 一, 丿, 一, 丨, 二
左	𠂇, 工	𠂇, 工	𠂇, 一, 丨, 一
佐	亻, 左	亻, 𠂇, 工	㇒, 丨, 𠂇, 一, 丨, 一
柞	木, 乍	木, 丿, 一, 丨, 二	一, 丨, 八, 丿, 一, 丨, 二
做	亻, 故	亻, 十, 口, ⺙	㇒, 丨, 一, 丨, 口, 丿, 一, 乂
作	亻, 乍	亻, 丿, 一, 丨, 二	㇒, 丨, 丿, 一, 丨, 二
坐	土, 从	土, 从	一, 丨, 一, 从
座	广, 坐	广, 土, 从	厂, 丶, 一, 丨, 一, 从
